성당 태왕아너스 메트로'는 분양시장이 초역세권 입지와 변화하는 라이프스타일에 맞춘 혁신평면으로 아파트 선택에 미치는 영향력이 커지고 있는 가운데, 분양관계자는 합리적인 분양가와 중도금무이자 등의 분양조건에 실수요자들이 높은 청약경쟁률을 기대한다고 밝혔다.	태왕의 '성당 태왕아너스 메트로'모델하우스는 초역세권 입지와 변화하는 라이프스타일에 맞춘 혁신평면으로 오픈 당일부터 관람객의 줄이 이어지면서 관람객의 호평을 받았다.
최근 늘어나고 있는 집회시위에서 가장 문제가 되는 것은 바로 '소음'이며 이러한 소음으로 인한 일상생활에 대한 고통을 해결하기 위해서는 법률적으로 미비한 점이 많다.	최근 늘어나고 있는 집회시위에서 소음이 문제가 되고 있는데 현행 집회와 시위에 관한 법률에서는 소음을 규제하고 있으나 그 기준이 일반 시민이 느끼는 기준과 괴리감이 심해 집회인들은 자신들의  요구를 전달하기 위해 확성기 사용은 불가피하다고 주장하고 있고 대다수 주민들은 소음으로 인해 많은 불편함을 느끼고 있다.
고흥군은 도시민 유치와 귀농·귀촌인의 안정적인 정착을 위해 지난 19일 옛 망주초등학교에서 송귀근 군수, 송우섭 군의회 의장, 귀농·귀촌인, 주민 등 300여명이 참석한 가운데 고흥 귀농귀촌행복학교 개교 행사를 가졌다.	지난 19일 고흥군에 따르면 송귀근 군수와 주민 등 300여 명이 참석한 가운데 귀농·귀촌인의 안정적인 정착을 돕고 영농교육 등을 담당하기 위해 지난해부터 추진했던 ‘귀농귀촌 행복학교'의 개교 행사를 했다.
23일 조선대학교 하이다이빙 경기장에서 열린 여자 하이다이빙 최종전에서 호주의 이프랜드가 금메달을 차지해 대회 2연패를 달성했다.	23일 조선대학교에서 열린 여자 하이다이빙 최종전에서 호주의 이프랜드가 금메달을 차지해 여자 하이다이빙 최강자임을 다시 한번 입증했다.
인사혁신처는 2019년도 시간선택제 국가공무원 경력경쟁 채용시험 시행계획을 3일 사이버국가고시센터에서 발표했다.	사이버 국가고시센터에서는 시간선택제 공무원을 선발 하는데, 시간선택제 공무원은 통상적인 근무시간보다 짧게 근무하는 공무원을 말하며, 정년은 60세로 동일하고 승진소요 최저연수,보수는 근무시간과 비례해 인정.지급한다.
홍성군 오관지구 내 공동주택 건설 사업이 본격화 되면서, 민간사업자 공모는 3개월간 진행되고, 이후 지자체 인허가 및 설계를 걸쳐 빠르면 올 하반기 말이나 2021년 3월 본격적인 보상절차가 이루어질 예정이다.	한국토지주택공사는 지난 7일 홍성오관지구의 민간사업자 공모를 공고하고 사업자 선정에 착수하였으며 군 역세권내 공동 주택 건설을 비롯하여 원도심 지역의 개발이 가시화되고 있다.
국토부는 미계약분 물량이 일부 현금 부자들에게 돌아가는 일명 '줍줍현상'을 방지하기 위해 청약시스템(아파트투유) 개선이 필요한 사항으로 이달 20일부터 예비당첨자 비율을 5배수로 확대한다고 밝혔다.	국토교통부는 당첨자 및 예비당첨자 모두 계약을 포기하거나 부적격 취소될 시 남은 물량을 무순위 청약으로 공급하였는데 최근 무순위 청약물량이 과도하게 발생하면서 일부에서 현금부자들이 아파트분양을 많이 받게되는 현상이 벌어져 이를 막기 위해 예비 당첨자 비율 확대 등을 통해 무순위 청약을 개선할 계획이라고 9일 밝혔다.
최근 경영애로를 겪고 있는 소상공인과 자영업자의 금융비용 부담을 완화하고 서민경제의 활력을 제고하기 위해 기업은행, 기술보증기금,신용보증재단 중앙회·기업은행이 31일 서울 중구 기업은행 본점에서 '소상공인·자영업자 특별 금융지원 업무협약'을 체결했다.	신용보증기금 등 3개 기관은 31일 서울 중구 기업은행 본점에서 최근 경영에 어려움을 겪는 소상공인 등의 금융비용 부담을 줄이고 서민경제에 활력을 주기 위해 '소상공인. 자영업자 특별 금융지원 업무협약'을 체결했다고 전했으며 지원대상은 필요한 조건을 갖춘 수출중소기업, 유망창업기업 등이다.
광주 지방 국세청은 17일 정부광주지방합동청사 3층 세미나실에서 혁신성장 기업 대표 50여명을 대상으로 다양한 세정지원 제도를 안내하는 동시에 기업 현장의 애로·건의사항을 경청하기 위해 ‘상생하고 포용하는 세정구현을 위한’ 혁신성장 기업 세정지원 설명회를 열어 주목을 끌었다.	광주지방국세청은 '상생하고 포용하는 세정구현을 위한' 혁신성장 기업 세정지원 설명회를 열어 여러 세정지원 제도를 안내하고 기업 현장의 애로, 건의사항을 경청하며 기업 맞춤형 세정서비스를 제공할 것을 약속했다.
전국협동조합 노동조합 경기·인천지역본부 노조원들은 30일 강화읍 강화 옹진 축산업협동조합 본점 앞에서 조합 자체감사와 2번에 걸친 농협중앙회 감사, 검찰의 수사과정에서 조합장이 임의 채용한 서울축산물유통센터(센터)장 A씨에게 부당한 자금 지원을 하는 등 비상식적인 약정으로 막대한 재산상 손실을 끼쳐온 축협장의 즉각적인 퇴진을 촉구했다.	전국협동조합 노조원들이 비상식적인 약정으로 막대한 재산상 손실을 끼치고 적자결산을 하는 등 부실·방만 경영을 한 조합장의 즉각적인 퇴진을 촉구했다.
인천시 연수구는 송도동 9천427m2 규모의 부지에 도서관을 건립하기 위해 총 사업비 393억100만 원 중 토지매입비 90억 원과 용역비 등을 포함하여 117억 원을 지출했고, 4월에는 송도5동에 청소년수련관, 송도5동 행정복지센터, 거점형 공공직장어린이집을 건립하기 위해 6천9m2를 인천경제자유구역청으로부터 54억4천171만 원을 들여 매입하였다.	인천시 연수구가 주민시설 건립을 연이어 추진하여, 일각에서 재정부담에 우려를 보였다.
MBC '뉴스데스크'에 따르면 지난해 7월 7일 새벽 5시 1분, 한 남성이 몸부림을 치며 동공이 크게 확대돼 있다는 내용의 119 신고 전화가 걸려왔다고 전했다.	손님 폭행 논란을 시작으로 성폭행과 마약 의혹을 받고 있는 클럽 버닝썬에 대한 VIP 고객의 증언이 확보돼 의혹이 커지고 있다.
22일 기획재정부는 경남 창원·거제·통영·고성, 울산 동구, 전북 군산, 전남 목포·영암·해남 등 고용·산업 위기 지역의 설 경기를 활성화하기 위해 '비상금' 성격의 일반 예비비와 특별 교부세를 900억 원 규모로 지원한다고 밝혔다.	22일 국무회의에서 기획재정부가 발표한 '설 민생안정 대책'의 내용에 따르면, 정부는 설 경기를 활성화하기 위해 고용·산업 위기 지역에 일반 예비비 900억 원을 지원하며, 자금난을 겪는 중소기업과 소상공인에게 33조 원을 지원한다. 
6일 송 송갑석 의원은 안중근의사 기념관, 백범 김구 기념관 등이 전범기업과 특수관계에 있는 에스원과 보안서비스 계약을 맺고 있어 부적절하다는 지적을 받고 있다고 밝혔다.	전범기업과 특수관계에 있는 보안업체 '에스원'이 항일 독립운동의 상징인 안중근 의사 기념관, 백범 김구 기념관, 독도 의용수비대 기념관을 지키는 것이 과연 적절한지에 대한 의문이 나오고 있다.
광양시는 평화의 소녀상이 건립될 광양역사문화관 앞 건립모금도 당초 목표액과 달성 시기를 앞당기며 2월 2일 현재 9000만원을 넘기고 건립모금도 당초 목표액과 달성 시기를 앞당기며 3월 1일에 광양역사문화관 앞 건립을 확정한다.	광양 평화의 소녀상'은 시민여론조사를 통해 선택된 최종 장소 3곳 중 역사성과 접근성이 가장 좋은 광양역사문화관에 건립되기로 했다. 
인천시는 2019년 새해를 맞아 교육문화, 복지, 여성과 노인, 일자리, 환경 등에 대한 올해 청사진을 제시하며 시민에게 직접 혜택을 줄 수 있는 교육과 문화, 복지 등 분야에 대한 지원책을 확대한다.	인천시는 1일 2019년 부터 달라지는 지원 정책을 소개하는 책 ‘2019년 인천시민의 생활은 어떻게 달라질까요’을 발간했다.
김무일 선생 김무일 선생은 1927년 12월 10일경 태인동에서 조선어로 된 문서에 일제의 불법 감금 폐지와 조선어 사용 확립 조선어 교사 등용 등의 내용을 담은 문서를 광양 일대에 배포한 혐의로 일본경찰에 체포돼 소위 출판법 위반으로 금고 6개월에 집행유예 3년형을 받았다.	김태수, 최영근, 최한원, 김무일, 최백근 등은 일제에 맞서 하동 독립운동을 주도한 주요 광양 독립운동가들이다. 
안산시는 아프리카돼지열병(ASF) 확산 방지를 위해 28일 예정된 제34회 시민의 날 기념 체육대회의 공식일정을 취소하고 연기하기로 결정했다.	안산시는 경기북부지역과 인천 강화군을 중심으로 확진 사례가 잇따르고 있는 아프리카돼지열병확산 방지를 위해 28일 와~스타디움에 7천700여명이 참여할 예정이었던 제34회 시민의 날 기념 체육대회의 공식일정을 취소하기로 했다.
한국농수산식품유통공사(aT, 사장 이병호) 화훼사업센터는 여름철을 맞아 실내온도 조절, 공기정화, 벌레퇴치에 좋은 '기능성 반려식물 3총사'를 추천했는데, 이 식물은 암모니아, 일산화탄소, 포름알데히드 등 실내 오염물질을 흙 속 미생물의 영양원으로 활용해 공기를 정화해준다.	30일 한국 농수산식품유통공사 화훼사업센터는 본격적인 여름철을 맞아 공기정화, 벌레퇴치에 좋은 ‘기능성 반려식물 3총사’를 추천하며 식물은 증산작용을 하는데 이때 주변의 열을 흡수하게 되고 미세먼지에는 공기정화 식물이 도움이 된다고 말했다.
지난 13일 향아식당에서 열린 (사)한국예술문화단체총연합회 당진지회 정기총회에서 임세광 시인이 임기를 마칠 수 있도록 따뜻한 마음을 보여주고 격려해준 당진 예술인들에게 감사드린다고 전했다.	(사)한국예술문화단체총연합회 당진지회는 13일 제13차 종기총회를 열고 임세광 시인을 제5대 지회장으로 선출하고 2017년 결산 및 2018년도 사업계획(안)을 승인했으며, 임세광 신임지회장은 당진예총 발전에 힘쓰겠다고 말하였다.
경북지역에 큰 피해를 입은 영덕 재난상황실을 방문하여 피해 복구 상황과 안전대책 및 복원계획을 점검하는 등 지역민들에게 조속한 피해 복구와 지원대책 마련을 약속했다.	태풍 '미탁'으로 경북지역에 큰 피해가 발생하면서 자유한국당 의원들은 지난 4일부터 피해 사후 수숩을 위해 연일 현장행보를 보였고, 더불어민주당 경북도당도 재해지역을 돕기 위해 당력을 집중하는 등 민생행보에 집중했다.
광주시는 주요 핵심사업에 대한 과감하고 본격적인 예산투자를 통해 2020년을 '광주 도약의 해'로 만들어 갈 계획이다.	광주시가 광주형 일자리 만들기와 인공지능 중심도시 조성 등 주요 핵심사업에 대한 전폭적인 투자 유치로 2020년을 광주 도약의 해로 만들어 갈 것이라고 밝혔다.
경기도내 유권자 3분의 1을 차지하는 ‘20·30세대’를 대변할 청년층의 여의도 정치 입성은 여전히 난기류 양상이며, 중앙선거관리위원회의 내년 4·15 총선 지역구 출마 예비후보자 현황을 보면, 이날까지 등록된 도내 30세 미만 예비후보는 단 1명에 불과하다.	경기도 20·30세대 유권자는 전체 인구의 30% 규모를 차지하지만, 20·30대 예비후보자는 더불어민주당 1명, 자유한국당도 단 3명에 불과하며, 그마저도 청년 정치인들이 당내 경선을 거쳐 국회 입성하는 것은 현실적으로 어려움이 크다. 
광주세계수영선수권대회 성공개최를 기념하는 여자프로배구 광주 초청경기가 오는 9월 6일부터 8일까지 3일간 광주빛고을체육관에서 열리며, 각 구단들은 경기력 점검과 배구 저변확대, 프로배구단의 사회환원 차원에서 광주 초청경기를 갖기로 했다.	오는 9월 6일부터 8일까지 광주빛고을체육관에는 KGC인삼공사와 한국도로공사, 현대건설, IBK기업은행 등 여자 프로배구 4개 구단이 참여하여 광주.전남지역 배구붐 조성과 광주세계수영선수권대회 성공개최를 기념하는 여자 프로배구대회가 열린다. 
아디다스가 6월 8일 세계 해양의 날을 맞아 해양환경보호단체 팔리포더오션과 함께 '런포더오션'을 양재시민의 숲에서 개최하고 참가자를 모집하며, 아디다스와 팔리포더오션 단체가 협업을 통해 진행하는 글로벌 프로젝트로 서울을 포함한 로스앤젤레스, 뉴욕, 파리, 베를린, 런던, 바르셀로나, 밀라노, 상하이 등 전 세계 주요 도시에서 해양을 살리기 위한 러닝 이벤트가 열릴 예정이다.	스포츠 브랜드 아디다스는 해양환경보호단체 팔리포더오션과, 해양을 살리기 위해 전 세계 주요 도시에서 진행한 러닝 이벤트 '런포더오션'을 이번에는 양재시민의 숲에서 개최하고 5월 31일부터 6월 5일까지 참가자 1000여 명을 모집한다. 
경기문화재단 문화나눔센터는 가을맞이 문화·여행·체육 분야 활동 장려를 위해 도내 문화누리카드 이용자를 대상으로 '문화누리카드 갑·분·혜(갑자기 분위기 혜택) 이벤트'를 실시한다고 밝혔다.	경기문화재단 문화 나눔센터는 가을맞이 문화·여행·체육 분야 활동을 장려하고자  ‘문화누리카드 갑·분·혜(갑자기 분위기 혜택) 이벤트’를 진행하며,  경기지역 문화누리카드 소지자가 9월 한 달간 문화누리카드를 3만 원 이상 사용 후 그 영수증을 인증하면 추첨을 통해 소정의 상품을 증정할 예정이라고 밝혔다.
음성군 맹동면은 사랑의 모내기 행사를 맹동면 쌍정리 244-3 일원에서 주민자치위원 20여 명이 참석한 가운데 성료 했으며 행사를 주관하는 김태선 주민자치위원장은 사랑의 쌀 나눔이 경로당 어르신은 물론 지역의 저소득 계층 등 한 끼가 부족한 이웃들에게 조금이나마 생활의 도움이 되었으면 좋겠다고 말했다.	음성군 맹동면에서 지난 10일 사랑의 모내기 행사를 통해 경로당 어르신 및 지역의 저소득 계층 등 한 끼가 부족한 이웃들에게 쌀 나눔을 지원했으며, 이는 맹동면에서 겨울마다 진행해온 사랑의 고구마 나눔 행사에 대한 확장 사업으로 음성군 내 나눔 사업의 모범이 되고 있다.
부산 북구는 지난 17일 (재)부산인재평생교육진흥원, 부산대학교 중국연구소와 함께 지역 인문자산기반 평생학습문화 진흥을 위한 업무협약(MOU)을 체결하여 부산 북구의 인문자산을 활용한 평생학습문화 진흥을 위한 공동 브랜드 사업을 발굴하고 다양한 프로그램을 개발 운영하는데 상호 협력할 예정이다.	17일에 부산 북구는 공동 브랜드 사업 발굴과 다양한 프로그램을 개발 운영하기 위해 (재)부산인재평생교육진흥원, 부산대학교 중국연구소와 함께 지역 인문자산기반 평생학습문화 진흥을 위한 업무협약을 체결했으며, 이를 바탕으로 인문학 강좌와 인문 체험 ,축제를 통해 구민들을 지원하게 된다.
양주시의 적극적인 규제 개선 노력이 당초 자동차관리사업 공동대표 등록 불가 규제의 완화를 이끌어 냈으며 이는 자금난 등 어려움을 겪고 있는 자동차관리사업 사업자들에게 다소나마 도움이 될 것이다.	양주시는 자동차 관리 사업자의 공동명의 등록을 이끌어 냄으로 규제 완화를 이루었다.
광주광역시는 정보화 취약계층 정보이용접근 기반조성 등 정보격차 해소를 위해 1억2천300만 원을 투입해 ‘사랑의 그린PC 보급사업’을 추진한다.	광주광역시가 정보격차 해소를 위하여 1억2천300만 원을 투입해 기초생활수급자, 비영리단체 정보교육기관을 선정하여 7월부터 12월까지 600대를 보급하는 ‘사랑의 그린PC 보급사업’을 추진한다고 밝혔다.
괴산군은 18일 괴산읍 명덕초등학교에서 지역에 거주하는 다 문화가족과 괴산 군민이 함께하는 '2019년 세계인의 날 기념 어울림 한마당 체육대회'를 개최하여 레크리에이션, 체육대회 등 다양한 프로그램을 진행했으며 참가자 모두가 함께 즐길 수 있는 체험부스 운영을 통해 화합의 장이 펼쳐졌다.	괴산군은 지난 18일 지역에 거주하는 다문화가족, 외국인 근로자, 새터민가족, 괴산 군민 등 400여 명이 참석한 가운데 '2019년 세계인의 날 기념 어울림 한마당 체육대회'를 개최했으며 레크리에이션, 체육대회 등 다양한 프로그램과 체험부스를 운영해 참가자 모두가 함께 즐기며 화합하는 장을 마련하였다.
오비맥주를 보유하고 있는 브리토 AB인베브가 외국계 증권사들을 통해 롯데와 신세계 등 국내 유통 대기업과 국내외 대형 사모펀드(PEE)운용사에 오비맥주 인수 의사를 타진하고 있다고 보도된 가운데 대주주인 AB인베브가 자산 추가 매각 가능성을 일축했다.	국내 맥주 시장 1위 업체인 오비맥주 매각설이 흘러나오는 가운데, 29일 주류업계에 따르면 카를로스 브리토 AB인베브 회장은 최근 파이낸셜타임스(FT)와의 인터뷰에 따르면 매각 가능성을 일축했다.
삼성 라이온즈가 지난시즌 불펜의 핵심으로 활약했던 심창민의 군 입대와 최충연의 선발보직 변경 등으로 인해 새로운 필승조로 부상하고 있다.	삼성 라이온즈가 새롭게 꾸린 ‘젊은 불펜진’ 최지광(21)-이승현(28)-원태인(19) 조합이 시즌이 지날수록 안정감을 더해가며 필승조로 부상하고 있다.
서선진(59·세림조경건설(주) 회장·사진)대한격투스포츠연맹 회장은 젊은이들에게 꿈과 희망을 주기 위해 고교격투대항전을 시작했으며 앞으로 아시아 단체들과 함께 한국 격투기문화를 새롭게 변화시킬 것이라고 말했다. 	한국 격투기 활성화를 위해 대한격투스포츠연맹을 창설한 서선진 회장은 젊은이들에게 꿈과 희망을 주기 위해 고교격투기대항전을 시작했고 학생들이 올바른 길로 가 자신이 원하는 삶을 살아가는데 도움을 주고자 고교격투대항전을 개최하고 있다고 했다.
한세대학교는 2020학년도 수시모집을 오는 6일부터 10일까지 인터넷으로 접수를 받는다.	한세대학교의 2020학년도 수시모집은 전체 모집인원의 59.7%인 365명을 뽑으며 일반전형은 모든 학과에서 2단계로 진행되고 구체적으로 1단계는 학생부 100%로 모집인원의 7배수를 선발, 2단계에서 학생부 60%, 면접고사 40%를 반영해 최종합격자 196명을 선발한다.
김규학 시의원문화복지위원장은 최근 국가기념일로 승격된 2? 28민주운동의 역사적 보존과 정신계승을 위해 기존 단순 기념식 개최 조례로만 돼 있던 ‘대구시 2? 28민주운동기념사업 조례’를 국가기념일 위상에 맞도록 전부 개정조례안을 발의했다.	시의원문화복지위 이영애 의원의 ' 대구시 출산장려 및 양육지원에 관한 일부개정조례안'과 황순자 시의원건설교통위 소속 의원의 '대구시 아이돌봄 지원 조례안' 등 대구시의원들이 눈길을 끄는 조례안을 연달아 발의하고 있다.
선거법 개정안과 고위공직자범죄수사처(공수처)법 통과라는 결론을 얻으며 패스트트랙 정국이 일단락된 가운데 정치권에서는 각 당의 이해득실에 관심이 쏠리고 있으며 특히 더불어민주당은 지난 23일 시작한 철야 국회 농성에 거의 전원이 참석할 만큼 결속력이 강해졌다고 평가된다.	여야 5당 간의 물리적 충돌을 보이기도 했던 패스트트랙 정국이 5일 만에 선거법 개정안과 공수처법 통과라는 결론을 얻으며 일단락되었고, 각 당의 이해득실에 관심이 쏠리고 있다.  
유니세프 아동친화도시 조성을 목표로 성남시가 지난 21일 수정구 위례광장로 36 위례역푸르지오아파트 4단지 내에 다함께돌봄센터 2호점을 열고 아동과 학부모 및 아동 관련 기관 종사자 24명을 수용할 수 있다.	21일 성남시는 수정구 위례광장로 36 위례역푸르지오아파트 4단지 안에 방과 후 아이돌봄서비스 은수미 Care’ 다함께돌봄센터가 문을 열었다고 밝혔다.
2019 광주세계수영선수권대회 다이빙 여자 1m 스프링보드 종목에서 김수지 선수가 동메달을 획득하여 한국선수가 세계대회 다이빙 종목에서 메달을 딴 것은 개인적으로는 인간승리이고 국가적으로는 희망을 안겨준 메달이라는 것을 증명했다.	2019 광주세계수영선수권대회에서 김수지 선수는 다이빙 여자 1ｍ 스프링보드 종목에서 동메달을 획득하고 개최국 자격으로 참가한 한국 여자수구 팀은 세계 최강팀을 상대로 열심히 싸웠다.
오디엔터테인먼트 오디엔터테인먼트 프로젝트 '팝시컬'(POPSICAL) 핑크레이디의 멤버 서윤과 이후, 예주, 우림, 현지가 다양한 이력과 매력으로 데뷔 전부터 화제를 모으고 있다.	오디엔터테인먼트 '팝시컬' 그룹 핑크레이디 멤버들의 남다른 노래, 연기, 춤 이력이 데뷔 전부터 화제를 모으고 있다.
김하늘은 지난 2016년 3월 1살 연하 사업가 최진혁 씨와 결혼식을 올려 지난 해 5월 딸을 출산한 바 있으며 올해 1월에는 자신이 세레명인 세실리아로 글 하나를 기고해 누리꾼들의 시선을 사로잡았다.	2016년 3월 1살 연하의 사업가 최진혁 씨와 결혼식을 올린 김하늘이 결혼 후 복귀작인 멜로 드라마 《공항 가는 길》에 이어 지난해 5월 딸을 출산한 뒤  jtbc 월화드라마 ‘바람이 분다’로 컴백한다.
전남도는 양파 생산량이 전국 평년보다 15만1천t 과잉될 것으로 전망됨에 따라 6월 초까지 중만생종 1만t, 163ha를 신속 시장 격리할 계획이다.	전남도는 28일  2019년산 양파 재배 생산 단수가 크게 늘어난 반면 가격은 장기간 하락 기조를 유지하고 있어 경영 안정에 어려움을 겪는 재배농가의 부담을 덜어주기 위해 자체적으로 중만생종 1만t, 163㏊를 신속 시장 격리할 계획이라고 밝혔다.
지난해 경기 부진과 부동산 규제 정책이 맞물려 부동산 개발ㆍ공급업이 관련 통계가 집계되기 시작한 2000년 이후 가장 부진했던 것으로 나타났으며, 경기가 어려울 것이라는 전망에 무게가 실리면서 관련 일자리 지표도 힘을 받지 못하는 모양새다.	작년 부동산 개발·공급업이 3년째 감소하며 19년새 가장 부진한 것으로 나타났으며 이는 문재인 정부 출범 이후 잇따른 고강도 규제 정책이 겹친 영향이라는 분석이다.
광주 북구가 2019년 1월 1일 기준 개별공시지가를 결정·공시하고 오는 7월 1일까지 이의신청 접수를 받는 가운데, 이의신청을 원하는 이는 동행정복지센터나 북구청 토지정보과 지가조사팀으로 제출하면 된다.	"광주시 북구 지역의 공시가격이 일부 지역 토지개발사업 등에 따라 전년 대비 7.38% 증가한 가운데, 가장 비싼 땅은 용봉동 전남대 후문 인근인 것으로 나타났다.

"
정부가 외화보유고 일부로 출자해 만든 국부펀드를 운영 중인 한국투자공사(KIC)가 자체 운영자금(내부적립금) 70%를 부동산에 몰빵 투자하고 있는 것으로 확인됐다.	김경협 민주당 의원이 확인한 자료에 따르면, 한국투자공사(KIC)가 자체 운영자금의 70%를 부동산에 집중투자했을 뿐만 아니라 내부 리스크분석팀의 우려에도 불구하고 지난 4월 1천100억 원을 신규 부동산에 투자한 것으로 나타났다.
증평군은 안전도시 위상 강화를 위해 NH 농협손해보험사와 새로운 '군민 안전보험' 계약을 체결하여 자연재해 사망하거나 스쿨존 교통사고로 인한 부상 시 최대 1000만원까지 보장받을 수 있으며, 의료사고 법률비용으로 1000만원까지, 강력·폭력 범죄 상해 치료비(1개월 이상 진단 시)로 400만원까지 보장한다.	증평군은 안전도시 위상 강화를 위해 군민 안전보험 계약을 체결했고 자연자해 사망시 1천만원 보장 받으며 의료사고시 1천만원까지 상해 치료비로 400만원까지 보장한다.
익산시는 ‘문화재 야행’이 4일~ 5일 이틀간 유네스코 세계유산 백제왕궁(왕궁리유적) 일원에서 개최되며, 야행은 지역의 역사성을 간직한 문화유산과 주변의 문화콘텐츠를 활용해 역사체험의 기회를 제공하는 행사다.	익산시는 4일과 5일 이틀간 유네스코 세계유산 백제왕궁 일원에서 여러 공연들과 관람객 체험프로그램을 진행하는 '문화재 야행'을 개최하며, 야행 관람객들은 스탬프 투어를 통해 소정의 기념품을 획득할 수 있다.
동아대학교 경영대학은 뉴턴의 사과나무 공원이 준공 후 첫 봄을 맞아 'BEYOND LOUNGE(비욘드 라운지)'란 이름이 붙으며 승학캠퍼스 곳곳을 새 단장하고 학생들이 폭발적인 반응을 보이고 있다고 5일 밝혔다.	동아대학교는 승학캠퍼스를 새 단장해 학생들이 폭발적인 반응을 보이고 있다고 5일 밝히면서 비욘드 라운지,뉴턴 공원 등을 소개하며 교수와 학생들이 이곳에서 활발히 소통하며 강의를 진행하고 있다고 전했다.
폭염이 이어지면서 채소가격이 5배가량 올라, 대구 북구 한 대형마트를 찾은 이모(53·여)씨는 열무김치 가격이 1주일 새 6천 원에서 1만 원까지 뛰었다고 밝혔다.	"4일 한국농수산식품유통공사(aT)에 따르면 가시 오이와 열무는 각각 3.5배, 2배, 적상추와 시금치, 애호박 등의 가격은 무려 5배 가까이 올랐으며 물량 부족으로 채소가격은 다음 주까지 높게 형성될 것으로 전망했다.
 "
하남시 대표 캐릭터인 하남이와 방울이가 ‘2019 대한민국 지역공공 캐릭터 대상(제2회 우리동네 캐릭터 대상)’에 첫 출전하여 장려상을 수상하였는데, 이는 길에서, 매체를 통해, 일상에서 마주친 적 있는 지역·공공 캐릭터들이 톡톡 튀는 개성과 이야기를 품고 보다 많은 사람들의 사랑을 받기 위해 경쟁하며 즐기는 대회인 만큼 관계자는 “하남이와 방울이’가 본선에 진출하여 본선에 진출하는 쾌거를 이루게 되어 기쁘다고 전하였다.	하남시의 대표 캐릭터인 '하남이'와 '방울이'가 문화체육관광부와 한국콘텐츠진흥원이 주관하는 2019 대한민국 지역공공 캐릭터 대상에 출전하여 본선에 진출한 16개 지역 공공캐릭터와 열띤 경쟁을 펼치고 현장에서 좋은 호응을 얻은 끝에 장려상을 수상했다.
괴산군은 지역단위 먹거리 선순환 체계 구축 확산을 위해 농식품부가 지자체에 지역 먹거리 종합계획 수립을 지원하는 사업인 '푸드플랜 수립 지원 공모사업'에 최종 선정되었다.	괴산군가 다양한 문제를 연계해 지역단위 먹거리 선순환 체계 구축 확산을 위해 수립한 '푸드플랜 수립 지원사업'이 림축산식품부가 주관한 '푸드플랜 수립 지원 공모사업'에 최종 선정되었다.
가평군은 내년 1월 말까지 70여 일간 이웃사랑 캠페인 대장정을 펼친다고 밝혔으며 이 기간 군민 관심을 환기하고 기부 및 나눔 분위기 조성을 위해 경기북부 사랑의 열매가 가평읍 오리나무길 로타리에 설치한 ‘사랑의 온도탑’을 통해 모금 실적을 홍보하게 된다.	가평군은 복지사각지대에 있는 이웃을 위한 기부 및 나눔 분위기를 조성하기 위하여 내년 1월말까지 70여 일간 이웃사랑 캠페인 대장정을 펼칠 예정이다. 
김해시 대성동고분박물관은 기존 기증 및 소장 유물 51점, 경남도가 관리를 위임한 국가 귀속유물 9967점을 모두 대성동고분박물관에 보관, 관리하고 있으나 일본의 무나카타시 우미노미찌박물관과 자매결연을 맺어 매년 교류사업을 활발히 진행하고 있다.	김해시는 대성동고분박물관에 소장 유물이 도내 공립박물관 최초로 1만 점을 돌파했으며 이 박물관에 많은 유물이 소장된 것은 문화재청에 등록된 발굴조사 전문기관으로 소장, 연구, 전시하고 있기 때문이라고 밝혔다.
조선업이 위기를 맞으며 지역 상권도 휘청이고 있는 '거제도' 첫 편으로 27일 방송된 SBS ‘백종원의 골목식당’이 평균 시청률 1부 6.7% 2부 8.6%(이하 닐슨코리아 수도권 가구 기준)를 기록해 압도적인 동시간대 시청률 1위를 기록했다.	지난 27일 '백종원의 골목식당'은 '보리밥&코다리찜'의 주방점검 장면에서 동시간대 시청률 1위를 기록했다.
팔공산 친환경농업인들이 만든 '팜카페 8062'는 지역 농산물 전시·판매 뿐 아니라 이를 활용한 과채주스, 샐러드 등 신선한 먹거리 공급과 휴게·체험공간을 제공해 지역 농업경쟁력을 확보한다.	팔공산 친환경 농업인들이 직접 지역 농산물 전시·판매 뿐 아니라 다양한 먹거리 판매와 함께 휴게·체험공간을 제공하는 새로운 개념의 직거래 매장인 ‘로컬 팜카페 8062’가 18일 개점했다.
민주당과 자정 5분 전 선거제 개혁안과 고위공직자범죄수사처(공수처)법 등이 패스트트랙(신속처리안건)으로 지정되어 국회 본청 220호에서 507호로 장소를 급변경하고 한국당의 회의 방해에 대비해 질서유지권까지 발동했다.	자유한국당의 격렬한 반대 속에 더불어민주당, 바른미래당, 민주평화당, 정의당 여야 4당의 강력한 지지로 선거제 개혁안과 고위공직자범죄수사처(공수처)법 등이 패스트트랙으로 지정되며, 이번 사태는 우리나라 민주주의의 현주소를 보여주고 있다.
최훈 강원대 철학과 교수가 동물 윤리의 필요성을 설명하는 책 '동물 윤리 대논쟁'을 발간했다.	최훈 강원대 철학과 교수는 지난 10년간 동물 윤리에 대해 연구한 결과를 담은 책인 ‘동물 윤리 대논쟁’을 발간하여 동물 윤리가 지지를 얻지 못하는 원인으로 육식, 동물실험 등의 관행이 판단을 어렵게 한다고 주장하고 있다.
교육부는 '학교 노후시설개선 및 수업환경개선'의 효율적인 추진을 위해 2023년까지 5년간 18조 9000억원을 투입하여 쾌적한 학교공간을 확보하고 찜통·냉골교실을 해소한다는 중장기 계획이다.	교육부는 노후환경 개선, 위험요소 없는 학교, 미래 교육에 대응하는 학교라는 3가지 목표달성을 목적으로하는 학교 노후시설개선 및 수업환경개선 사업을 위해 2023년까지 5년간 18조 9000억원을 투입한다.
경기도는 도내 산업체에 우수 기술인력을 공급하고 청년 실업을 해소하고자 경기도가 두원공과대학교 파주캠퍼스에 위탁·운영 중인 맞춤형 취업교육기관 '2019년도 경기산업기술교육센터 상반기 교육과정'에 참여할 교육생을 오는 2월 25일 개강해 7월 19일까지 약 6개월간 모집한다.	경기도는 우수 기술인력 양성과 청년 실업 감소를 위해 오는 2월 25일부터 7월 19일까지 약 6개월간 진행되는 '2019년도 경기산업기술교육센터 상반기 교육과정' 의 교육생을 모집한다.
9일 브랜드가치 평가회사인 브랜드스탁에 따르면 삼성 갤럭시는 3분기 일본 시장점유율이 3배 늘어나는 등 눈에 띄는 약진을 보이고 있어 향후 브랜드가치 향배가 주목된다고 밝혔다.	브랜드가치 평가회사인 브랜드스탁에 따르면 광주사업장에서 생산하는 삼성 비스포크와 위니아딤채의 김치냉장고 딤채, 금호타이어 등 광주지역 3개 제품이 100대 브랜드에 선정됐다.
지난 8일 발표된 '청와대 2기 참모진 인사'에 대해 더불어민주당은 국정쇄신 등에 대한 문재인 대통령의 의지가 드러났다고 평가한 반면 야당들은 국민 정서에 역행하는 비서진 개편이라며 비판적인 입장을 드러냈다.	청와대 3기 참모진 인사'가 발표되자 여당은 국정을 쇄신하겠다는 긍정적인 신호로 받아들인 반면 야당은 국민 정서에 역행한다며 비판했다.
경남도가 체험학습 등 야외활동이 많은 행락철에 대비해 8일부터 12일까지 5일간 청소년 수련시설 및 김밥, 도시락 제조업체를 대상으로 일제 합동점검을 실시하며 그동안 위반율이 높았던 식품 등의 위생 취급기준과 유통기한 경과제품 보관 및 사용 행위, 건강진단 실시 여부 등에 대해 집중적으로 점검할 예정이다.	경남도는 행락철에 대비해 8일부터 12일까지 청소년 수련시설 및 도시락 제조업체를 대상으로 합동점검반을 편성해 점검을 실시하고 실질적인 위생 개선 효과가 나타나도록 시설관리자 및 조리종사자 등을 대상으로 식중독 예방 현장 교육도 병행한다고 말했다.
광주시 청소년상담복지센터가 지난 4월 16일~ 8월 3일 5개월 간 운영한 ‘솔리언 또래 상담자와 함께하는 다문화 청소년 지원 사업’이 성공리에 마무리됐다.	광주시는 지난 4월16일~8월 3일 5개월간 다문화 청소년의 사회성 형상을 위해 '솔리언 또래 상담자와 함께하는 다문화 청소년 지원 사업'을 성공리에 마무리 했다.
본격적인 겨울철을 맞아 경기도내 도로에 살얼음이 끼어 발생하는 일명 블랙아이스로 인한 교통사고가 잇따라 발생해 운전자들의 주의가 요구되고 있다.	4일 도로교통공단 교통사고분석시스템에 따르면 지난 2016년부터 2018년까지 경기도 내 도로의 서리, 결빙 등 일명 블랙아이스로 인해 일어난 교통사고는 총 1천160건으로 나타났으며 부상자는 2천55명, 사망자는 17명에 달해 운전자들이 운행에 있어 조심할 필요성이 늘고 있다.
자유한국당 인천시당이 총선에 대비한 조직 개편을 단행해 여성위원회·청년위원회 등 각 조직의 역량을 지속적으로 발휘하도록 독려하는 데 중점을 두고 있다.	자유한국당 인천시당이 21일 총선에 대비하기 위해 여성위원회·청년위원회 등 각 조직의 역량을 지속적으로 발휘하는데 중점을 둔 조직 개편을 단행했다고 밝혔다.
석문중학교가 지난달 28일 한국동서발전(주) 당진화력본부의 후원을 통해 역사 골든벨 대회가 열린 가운데 3학년 조재현 학생이 벨을 울려 노트북을 부상으로 받았다.	지난달 28일 석문중학교 밀알관에서 개최된 역사 골든벨 대회에서 3시간의 경쟁 끝에 3학년 조재현 학생이 골든벨을 울렸다. 
광주 남구는 지난 2014년부터 법무부와 연계해 법률상담과 관련 정보를 무료로 제공하고 있는 '법률 홈닥터' 서비스 이용 건수가 5천건 이상을 돌파했으며, 연도별 이용 현황을 보면 법률 상담이 4천95건으로 전체 이용건수의 78%를 차지했다.	광주 남구는 사회적 취약계층을 위한 법률지원서비스인 '법률 홈닥터 서비스'를 정기적으로 진행해 나갈 예정이라고 밝혔다.
1일 중앙일보는 중앙정부와 전국 광역ㆍ기초 지방자치단체가 노인과 노인을 부양하는 가정에게 제공하는 혜택을 분석한 '우리동네 어르신 혜택' 디지털스페셜을 공개했다.	중앙일보가 각 지역의 노인과 노인 부양 가정을 위하여 혜택을 정리한 사이트를 선보여서 화제이다.
전국 아파트값 하락과 초기 분양률 저조로 일부지역에서는 깡통전세와 역전세 현상까지 일어나고 있으나 광주·전남지역은 한전공대 부지 선정과 지하철 2호선 건설 호재 등으로 여전히 상승세를 유지하고 있는 것으로 나타났다.	 전국적으로 부동산 시장이 하락세이지만 광주·전남지역은 한전공대 부지선정과 지하철 2호선 건설 등으로 아파트 매매가격이 상승하면서 부동산 시장이 상승곡선를 유지하고 있다.
2020년 경자년 희망찬 새해를 여는 첫날인 1일은 창작국악단 도드리가 한해 농사를 시작하며 풍년을 기원하는 뜻을 담고 있는 '성주곡'으로 문을 열고 2일은 한국판소리보존회 광주지부가 '근하신년(謹賀新年)'이란 주제로 공연한다.	2020년 1월 1일 오후 5시 광주공연마루에서, 창작국악단 도드리의 ‘성주곡’을 시작으로 2020년 경자년 새해맞이 광주국악상설공연이 4일간 열린다. 
당진시는 오는 19일까지 미취업 청년들의 구직단념을 예방하고 다양한 직무능력 배양과 사회생활 경험 기회를 제공함으로써 민간으로의 취업을 지원해 주는 사업인 맞춤형 청년인턴을 모집한다고 밝혔다.	12일 당진시는 미취업 청년을 대상으로 구직단념을 예방하고 직무능력 기회를 제공할 목적으로 총 30명의 맞춤형 청년인턴을 오는 19일까지 채용한다고 밝혔다.
지난달 광주 롯데마트 첨단점 1층에 고추장부터 발효 커피, 생활자기 등 순창군에서 생산되는 특산품이 전시되어 도시민으로부터 눈길을 끌고 있다.	고추장, 발표 커피, 생활자기 등 순창군에서 생산되는 특산품이 대형마트 내 특설매장에 전시되었고 높은 이용률로 인한 홍보 효과가 클 것으로 기대하고 있다.
17일 정인화 의원이 국정감사를 위해 경찰청으로부터 제출받은 자료에 따르면 최근 3년간(2016-2018년) 광주·전남지역에서 공상을 입은 경찰공무원은 598명으로 2017년 89명에서 지난해 27명으로 11.2% 증가했고 범인으로부터 피습을 당한 경우가 2017년 16명에서 지난해 27명으로 68.8% 급증했고, 안전사고는 31.6% 증가했다.	임무수행 중 경찰관의 공상자가 광주는 2017년에 비해 11.2% 증가, 전남도 전년대비 35.8% 늘어나고 있어 경찰관을 보호하는 안전대책과 제도개선이 시급하다.
광주김치타운에서 생산하고 있는 김치가 학교 납품 과정에서 위생분야 부적격 평가를 받아 탈락한 것으로 드러났다.	"광주시의회 김점기 의원은 광주김치타운에 내 김치공장이 임대 전 시설 보수 및 보강을 하지 않아 위생상태 불량으로 평가받아 ‘0’점 처리가 돼 학교 납품업체 선정 부적격 평가를 받았다”고 밝히며 “광주 학생들에게조차 공급하지 못하는 김치를 전국화, 세계화하겠다는 것은 어불성설”이라고 지적했다.
"
전남도가 간선도로망 구축에 필요한 여수, 고흥, 신안, 진도 등 지방도를 국도로 승격해줄 것을 지속적으로 건의하고 있다.	 전남도는 체계적 도로망 구축,관리를 위해 국토교통부에 지방도로를 국도로 승격해줄것을 건의하고 있다.
선거법 공수처법 등으로 공전이 된 국회 일정을 뒤로 두고 대구·경북(TK) 자유한국당 의원들이 지역민들과 애환을 함께 하기 위해 발빠른 민생 행보에 돌입했다.	"  곽대훈 한국당 대구시당 위원장은 패스트트랙으로 인한 국회의 운영이 잠시 중단된 가운데 대구·경북(TK) 자유 한국당 의원들이  지금 중요한 것은 민생경제이니 지역구 의원들의 민생현장 방문을 주문하고 있다”고 말했다.
  "
충남교육연수원'은 지난 5일, 6일 양일간 도내 교사들의 접근이 용이한 덕산 리솜스파캐슬에서 정찬필 총장 등 14명의 교사를 강사로 초빙하여 '거꾸로 교실 캠프'를 운영하여 수업 혁명으로 학교 혁신이 되도록 하였다.	충남교육연수원은 새해를 맞아 1월 5일,6일에 덕산 리솜스파캐슬에서  '2019 질문이 있는 교실 거꾸로 교실 캠프'를 열어 참여 교사들이 수업시간에 강의를 하지 않고 미래교실네트워크 정찬필 총장 등 초빙된 14명의 교사에게 수업을 듣는 등 학생 참여형 수업 방식을 경험하게 해 큰 호응을 얻었다.
순창군은 팔덕다용도보조구장(야구장·축구장) 완공에 따른 경기장 활성화를 위해 2020년 동계시즌(12월~2월) 야구, 정구 전지훈련단 유치와 대회 개최에 대한 구체적인 성과를 거뒀다.	순창군은 편의시설 확충, 제설 대책 강구, 감성 마케팅 등으로 전지훈련단을 유치하여 지역경기 활성화를 위해 노력하고 있다.
지난 8일 오후 4시 당진시청 접견실에서 골프장과 복합리조트 건설을 추진 중인 라미드 호텔&리조트는 석문산단 내 체육시설용지에 대해 계약을 체결하고 계약금도 납부했으며 앞으로 석문산단 체육시설 부지에 27홀을 갖춘 골프장과 클럽하우스를 건설할 예정이다.	당진시는 석문산단에 27홀을 갖춘 골프장과 복합리조트 건설을 추진하기 위해 라미드 호텔&리조트의 문병욱 회장과 투자협약을 지난 8일 체결했다고 밝히며 협약에 앞서 라미드 호텔&리조트는 체육시설용지에 대해 계약을 체결하고 계약금 납입도 했다.
옥천군보건소는 사고가 발생한 때부터 현장 응급의료에 관한 기본적인 사항을 정하고 신속한 구호를 위한 대응 매뉴얼을 숙지대처하기 위해 지역내 6개 기관과 재난의료 협력체계 구축을 위한 업무협약을 체결했다.	옥천군보건소는 자연재난을 비롯한 생물테러, 다수사상자사고에 대비 및 대응하기 위해 옥천소방서, 옥천경찰서, 옥천성모병원, 육군 2201부대, 대한적십자옥천지구협의회 등 지역 내 기관과 재난의료 협력체계 구축을 위한 업무 협약을 맺고, 협약을 통해 사고가재해 등으로 인해 응급환자가 발생한 경우 신속하게 응급처치와 이송이 가능하도록 적극 협력하고 이송된 중증환자에 대해서는 최선의 의료서비스를 제공하기로 합의했다.
광주시 동구가 오는 8일 오후 7시 지산유원지 공영주차장에서 ‘생생문화재 달빛음악회’를 개최하고 문화재를 중심으로 체험, 투어, 콘서트를 진행하는 ‘오감만족 풍류산책’ 프로그램이 운영된다.	광주시 동구가 지산유원지 공영주차장에서 지난해부터 문화재청 공모사업으로 오지호 화백 가옥 등 지역소재 문화재를 중심으로 체험, 투어, 콘서트를 진행하는 ‘오감만족 풍류산책’ 프로그램이 운영, 이번 음악회는 지산동오층석탑(보물 제110호), 자운사 목조아미타여래좌상(보물 제1507호) 등을 배경으로 ‘생생문화재 달빛음악회’를 개최한다.
이현재 의원은 ‘국토부와 함께하는 5호선 조속개통, 9호선 조기착수’ 토론회 후속조치로 ‘9호선 하남구간 조기착수를 위한 시민 서명운동’에 착수하며  선행구간인 강일구간의 조속한 확정과 동시에 하남구간의 조기착수를 위해 시민서명을 받아 국토부, 대도시권광역교통위원회 등에 전달할 예정이다.	국회 국토교통위원인 이현재 의원은 국토부에 9호선 강일구간을 광역철도로 지정해 추진해 줄 것을 요청하고  9호선 하남 구간 연장 공사가 빠른 시일 내에 시작될 수 있도록 ‘9호선 하남구간 조기착수를 위한 시민 서명운동’에 착수한다고 밝혔다.
경기도의회 건설교통위원회 소속 권재형 의원은 지난 11일 도의회 의정부상담소에서 경기도 교통국 관계자들과 간담회를 통해 민락지구 광역 전세버스 운행 계획안에 대해 논의하는 시간을 가졌다.	경기도의회 건설교통위원회 소속 권재형 의원은 지난 11일 도의회 의정부상담소에서 의정부 민락지구 전세버스 운행 계획안에 대해 논의하여, 최근 출근시간대 시민불편을 해소하기 위해 의정부 민락지구 전세버스를 오는 2월 1일부터 운행할 계획이다.
지난 22일 부산공동어시장은 임시총회를 열고 지난 13일 치러진 제2회 전국동시조합장선거 결과에 따라 새로 선출된 대표이사 선거가 다음 달 19일 치러질 예정이다.	지난해 파행되었던 부산공동어시장 선거가 다음 달 19일 치러지며, 정관 개정으로 낙선 인사들의 재도전이 줄 이을것으로  전망된다. 
광주시는 추석을 맞아 선불카드만 실시했던 10% 특별할인을 체크카드로까지 확대하고, 가맹점 카드결제수수료 전액 지원 대상도 연매출 5억원이하에서 10억원 이하로 범위를 넓혔다.	광주시는 추석을 앞두고 지역 경제 활성화를 위해 다음달 1일부터 '광주상생카드 10% 특별할인'을 실시하며, 시민들은 10만원까지 할인혜택을 받게 된다. 
한국토지주택공사(LH) 경기지역본부는 내달 11일부터 의왕고천, 화성동탄2지구 내 행복주택 3천26가구를 공급하며, 젊은 층(대학생, 청년), 여성(예비)신혼부부·한부모가족)의 주거 안정을 위해 직주근접이 가능한 부지를 활용, 시중 시세보다 저렴하게 공급할 예정이다.	한국토지주택공사 경기지역본부가 젊은 층의 주거 안정을 목적으로 의왕고천, 화성동탄2지구 내 행복주택 3천26가구를 시중 시세보다 값싸게 공급하며 10월 11일부터 21일까지 신청을 받는다.
괴산군 보건소 치매안심센터는 28일 괴산읍 전통시장 일원에서 시장상인과 지역주민을 대상으로 치매에 대한 부정적 인식과 편견을 줄이기 위해 치매인식개선, 치매치료 관리비 지원 등 치매지원서비스 홍보와 치매안심센터 홍보물품 배부 등을 배부했다.	치매에 대한 부정적 인식과 편견의 감소를 위해 괴산군 보건소 치매안심센터는 시장상인과 지역주민을 대상으로 배회가능 어르신 인식표 및 치매치료 관리비 지원 등 치매지원서비스 홍보를 비롯하여 치매관련서비스 안내문과 치매안심센터 홍보물품 등을 배부하며 캠페인을 펼쳤다. 
전남도는 관광산업을 국가 신성장 동력으로 주목하고 해양치유·해양생태관광을 중심으로 블루 투어리즘(해양생태관광)의 허브이자 국제적 해양관광명소로 집중 육성할 계획이다.	전남도가 ‘대한민국 관광 중심, 글로벌 전남 관광’ 비전을 선포하고 관광객 6천만명 시대를 위해 경남, 부산과 협력해 남해안을 세계적 해양 관광의 중심이자 대한민국 경제의 새 중심축으로 육성할 계획이며, 여행하기 편한 관광 여건 마련을 위해 빅데이터를 기반으로 한 전남스마트 관광안내 시스템도 7월부터 운영할 계획이다.
제39주년 5.18 민주화운동 기념일을 이틀 앞둔 16일 김영록 전남도지사는 박병호 행정부지사와 윤병태 정무부지사, 간부 공무원, 1980년 태생 도청직원 등 200여명과 국립 5.18민주묘지를 방문해 헌화와 분향을 시작으로 묵념, 묘역 순례 등을 진행했다.	김영록 전남도지사가 제39주년 5·18민주화운동 기념일을 앞두고 박병호 행정부지사와 윤병태 정무부지사를 비롯한 200여 명과 헌화와 분향, 묵념 등으로 국립 5·18민주묘지 합동 참배를 했으며 오월 민주 영령의 정신을 살리기 위해 정의와 진실을 바로 새우겠다는 방명록을 남겼다.
인류무문화유산 등재를 앞둔 올해 축제에서는 남북 평화기원 퍼포먼스와 남북화합 소지쓰기 등 다양한 행사가 이어졌고 수 천 명의 사람들이 직경 1미터, 길이 200m, 무게 수 십 t의 줄을 옮긴 뒤 물 윗마을(水上)과 물 아랫마을(水下)로 편을 나눠 줄을 당기며 한 해 풍년농사와 국민들의 화합을 기원했다.	인류무형문화유산에 등재된 이후 네번째를 맞이한 당진 대표 기지시줄다리기 민속축제가 남북 평화기원 퍼포먼스 등의 한반도 평화기원 행사와 함께 사흘간의 일정이 마무리되었다.
제2회회 전국동시조합장 선거(3월13일)를 한달여 앞두고 대구·경북지역에서는 입후보예정자가 조합원에게 금품을 제공하거나 선거성 발언을 하는 등 불법 사례가 상당수 발견되어 선거가 공명정대하게 이뤄질 수 있도록 노력하겠다고 밝혔다.	3월 13일에 시행되는 제2회 전국동시조합장 선거 앞두고 7일 대구·경북선거관리위원회의 대구·경북지역 조합장 선거 관련 고발 7건, 경고 12건 등이 발생하는 등 '일단 제보하고 보자'는 분위기가 형성되어 벌써부터 혼탁선거 양상을 보이고 있다.
제2의 축구대표팀 트레이닝센터로 불리는 대한민국 축구종합센터는 전국 24개 지방자치단체가 올 초부터 치열한 경합을 벌여 결국 천안시가 우선협상 대상 1순위로 선정되면서 명실공히 대한민국을 대표하는 축구메카로 거듭나게 된다.	천안이 접근성, 축구인프라, 지자체의 의지 등 여러 가지 조건을 등에 업고 대한민국 축구종합센터(NFC) 우선협상 대상 후보지 1순위로 선정되면서 체육의 저변 확대와 지역경제 활성화를 추진하겠다고 발표했다.
대구 달서구의회는 12일 개회된 제260회 임시회에서 ‘두류정수장 후적지 대구광역시 신청사 유치 촉구 결의문’을 채택하고 두류정수장 후적지 앞에서 대구시 신청사 달서구 유치 결의대회를 진행했다.	대구 달서구의회는 대구시청사의 달서구 두류정수장 후적지 유치 공론화를 위해 12일 개회된 제260회 임시회의에서 구의원 24명 전원이 공동 발의한 '두류정수장 후적지 대구시 신청사 유치 결의문'을 채택하고, 같은 날 오전 두류정수장 후적지 앞에서 결의대회를 열었다.
19일,과 ADT캡스가 실시간 주차 공간 확인부터 결제, 통합 관제, 현장 출동까지 주차 관련 모든 서비스를 통합 제공하는 5G시대 주차 솔루션 'T맵주차'를 출시하여 운전자에게는 전용 앱을 통해 주차 공간 조회, 할인, 자동결제까지 가능한 원스탑 초간편 주차 서비스를 제공한다.	SK텔레콤과 ADT캡스는 첨단 ICT기술이 결합된 주차 솔루션으로 운전자에게 전용 앱을 통한 실시간 주차 공간 조회 및 할인 등으로 운전자의 수요 공급 불일치 등의 불편함을 해소할 전망이라고 밝혔다.
독도 소방구조헬기 추락사고 범정부현장수습지원단은 헬기 추락사고 당시 분리된 헬기 꼬리부분을 인양했다고 밝혔다.	지난달 31일 수색당국이 독도 소방구조헬기 추락사고 발생 21일 만에 블랙박스를 수거했으나 사고 원인을 찾기까지는 1년 이상 걸릴 것으로 보인다. 
제7회 전국동시지방선거가 오는 6월 13일에 진행되는 가운데 지난 2일부터 윤기섭씨가 가장 먼저 당진시선거관리위원회 후보 접수를 하고, 강익재, 오동원, 윤기섭, 손종, 임종억·이화용씨가 예비후보로 접수하면서 기초자치단체장, 광역·기초의원 예비후보자 등록이 시작됐다.	오는 6월 13일에 진행되는 제7회 전국동시지방선거가 예비후보자 등록이 지난 2일 시작되어 윤기섭 등 당진의 후보들이 합법적인 선거운동을 위해 후보자 접수를 마쳤다. 
제13회 한진포구 바지락 갯벌체험 축제가 지난달 26일부터 28일까지 한진포구 일원에서 열렸으며 축제 첫째 날에는 개막식과 함께 현진우, 온희정, 한가빈, 성은이 등 지역가수들이 참여한 바다콘서트가 개최됐다.	제13회 한진포구 바지락 갯벌체험 축제가 지난달 26일부터 28일까지 한진포구 일원에서 첫째 날 개막식과 바다콘서트, 둘째 날 다양한 체험행사등의 프로그램으로 열렸다.
아산시는 배방신도시의 인구증가에 따른 대중교통을 이용하려는 주민들의 편의를 돕기 위해 지난해 10월 배방읍 공수리에 37억 원의 예산을 투입해 전체 면적 7524m2 규모의 배방환승정류장을 설치하였으나 인근 시외버스 정류장은 정차 횟수가 많지 않아 향후 추가정차 가능여부 결정에 관심이 쏠리고 있다.	아산시는 배방신도시의 인구증가에 따라 대중교통을 이용하려는 주민들의 편의를 돕기 위해 지난해 10월 37억 원의 예산을 투입해 환승정류장을 설치했지만, 투자 규모에 비해 역할이 미비하다는 지적에 따라 활용성을 높이기 위해 충남도에 시외버스 추가정차를 요청했으며, 충남도는 운송 업체 관계자 등과 함께 현장답사를 마치고 현재 이 사안에 대해 검토하고 있는 것으로 알려져 그 결과가 주목된다.
자유한국당 추경호 의원은 도서구입비와 공연관람비, 박물관? 미술관 입장요금은 신용카드 또는 현금영수증 사용금액 중 우대공제율(30%)을 적용해 소득공제하고 있으나 도서와 같은 활자매체인 신문은 제외되어 있다고 밝혔다.	자유한국당 추경호 의원이 신문구독료에 대한 소득공제를 신설하고 연간 신문구독료를 고려해 해당 공제항목의 한도액을 120만 원으로 인상하는 조세특례제한법 일부개정법률안을 대표 발의했다.
광주·전남지역들의 국회 본회의 평균 재석률이 55.81%로 나타나 17개 시·도 가운데 세종시를 제외하고 가장 낮은 것으로 드러났다.	20대 국회 국회의원 3차년도 본회의 출결상황' 전수조사 결과에 따르면 광주·전남 지역구 국회의원들의 국회 본회의 평균 재석률이 각각 55.81%와 62.63%로 17개 시·도 가운데 세종시를 제외하고 가장 낮은 것으로 나타났다. 
전남도는 기획재정부가 재정사업평가위원회에서 목포-보성간 남해안철도 전철화 사업을 ‘사업계획 적정성’ 판정을 받아 오는 2022년 완공할 수 있게 되었다.	전남도는 27일 기획재정부 재정사업평가위원회에서 목포-보성 남해안 철도 전철화 사업이 확정되어 2022년 완공할 수 있게 됐다고 밝혀 목포-부산 간 2시간 40분대 왕래가 가능해질 전망이다.
전국공공연구노동조합은 18일 대전 연구개발특구진흥재단에서 기자회견을 열어 문재인 정부의 과학기술정책이 3년 차로 접어들었지만 현재 대한민국의 과학 기술 정책과 행정은 '위기' 상황으로 진단하고 국가 과학기술정책 정상화를 위한 방안으로 국가과학기술시스템 의사결정·자문기구 혁신, PBS(연구과제중심운영제도) 폐지 등을 제안했다.	전국공공연구 노조는 사람 중심의 과학기술 정책을 약조했던 문 정부가 과학기술 인사정책 및 부처 간 협력 실패로 인해 정책과 행정을 모두 실패 했으며, 현재의 문 정부 과학기술 정책을 위기 상황으로 진단하며 대한민국의 과학기술은 어두운 시간을 맞을것이라 주장했다.
GS건설 소프트웨어 엔지니어 분야 정규직 경력사원과 해외법무팀에서 근무할 변호사를 다음달 2일까지 모집하며, 전형절차는 서류전형, 면접전형, 신체검사 순으로 진행한다.	GS건설이 소프트웨어 엔지니어 분야에서 두 가지 직무와 법무 분야에서 해외, 국내 나눠서 두 가지 직무에 대한 채용 지원서를 다음달 2일까지 받는다.
시흥시가 오는 9월 20일부터 22일까지 3일간 시흥갯골생태공원에서 열리는 제14회 시흥갯골축제 진행할 갯골패밀리런 참가자를 모집하며, 갯골 패밀리런은 갯골의 동물친구의 특징을 활용한 다양한 소품을 직접 만들어 보고 이 소품을 착용해 퍼레이드 행렬에 참여하는 갯골 드레스룸이 새롭게 선보일 예정이다.	시흥시가 9월 20일부터 22일까지 제14회 시흥갯골축제 진행할 갯골패밀리런 참가자를 모집하며 참가자들은 생태 오리엔티어링 프로그램을 통해 소금 올림픽, 갯골모의고사 등 미션을 수행할 예정이다. 
문희상 국회의장은 3일 국회에서 열린 신년 기자간담회에서 선제적 민생입법이 가능한 국회로 거듭나겠다고 다짐하며 선거제 개혁 등 정치개혁의 필요성을 강조했다.	지난 연말 국회는 윤창호법, 김용균 법을 통과시켰으며, 문희상 국회의장은 정치개혁의 필요성을 강조하며 민생입법이 가능한 국회로 거듭나겠다고 말했다. 
정부가 올해조원이 넘는 예산을 확장적으로 편성한 덕분에 내년 국민 한 사람이 평균적으로 부담해야 할 실질 나랏빚이 767만원으로 뛸 전망이다.	정부가 2020년 예산안을 확장적으로 편성한 결과 내년 국민 한 사람이 평균적으로 부담해야 할 실질 국가채무는 2015년 중동호흡기증후군(MERS)을 수습하기 위해 추가경정예산을 편성했던 이후 가장 높은 767만원으로 뛸 전망이다.
이철우 경북도지사는 지난 23일 4당 원내대표를 방문해 sk하이닉스 반도체 특화 클러스터 구미 유치를 적극 건의하고 SK 하이닉스 구미 유치를 위해 국회 차원의 적극적인 협조를 이끌어 낼 것이라고 밝혔다.	이철우 경북도지사가 23일 SK 하이닉스를 충분한 부지를 보유한 구미에 유치되어야 한다며 4당 원내대표를 설득하고 지방이양일괄법 조속 처리, 지방자치법 개정안 재검토 등의 건의 내용을 전달하였다. 
대구시는 8일 칠곡 향교에서 ‘스마트 웰니스 규제자유특구 발전방안’이라는 주제로 정책포럼을 개최하여 특구 내 규제혁신과 관련 산업의 육성 및 발전 방안을 논의한다.	대구시는 8일 칠곡 향교에서 대구 의료와 웰니스 분야의 혁신 성장과 글로벌 확산을 위해 특구 내 규제혁신과 관련 산업의 육성 및 발전 방안을 의논하기 위해 '스마트 웰니스 규제자유특구 발전방안'이라는 주제로 발표와 패널 토론으로 구성된 정책포럼을 진행한다.
포스코건설이 14일 인천 부평아트센터 해누리극장에서 개최된 '제4회 인천시 어린이 합창대회'에 참가한 어린이들이 수 개월간 연습을 거듭하며 기량을 마음껏 펼치고, 조화와 배려의 의미를 배우며 성장하는 모습을 보였다.	제4회 인천시 어린이합창대회가 14일 인천 부평아트센터 해누리극장에서 총 12개 팀이 본선에 진출해 경연을 펼쳤으며, 관객들은 승패 구분 없이 박수와 환호로 아이들을 응원했다.
부산시는 상습 정체 구간인 동서고가로에 다음달 19일까지 교통사고가 자주 발생하는 황령램프~감전램프 시외 방향 구간에 구간 단속 카메라를 설치한다고 밝혔다.	부산시는 동서고가로 황령램프~감전램프 시외 방향 구간에 구조물 진동의 영향을 받지 않는 레이더 방식 구간 단속 카메라를 설치하여 5월부터 단속을 시행한다.
3.1운동 및 대한민국 임시정부 수립 100주년을 기념해 광주지방보훈청은 ‘광주독립만세운동 재현 행사와 독립의 횃불 봉송’ 행사를 추진한다고 18일 밝혔다.	3·1운동 100주년을 기념해 기획된 '광주독립만세운동 재현 행사와 독립의 횃불 봉송' 행사를 위한 독립의 횃불이 다음달 1일 서울 광화문광장을 출발하여 25일 광주에 도착해 5·18 민주광장까지 봉송된다고 광주지방보훈청이 18일 밝혔다.
전남교육청 시베리아 횡단 독서토론열차학교의 정신을 계승하고 학생 스스로 교육활동을 기획하고 참여하는 학생통일자치학교 형태로 오는 3월18일까지 참가학생 모집을 한다.	3·1운동 100주년을 맞아 전라남도교육청이 기획한 '2019 전남통일희망열차학교'는 역사의식과 통일의지를 갖춘 고등학생을 대상으로 역사교육과 통일교육을 강화하고 열차학교의 북한 경유를 성사시킬 계획이다.
여론조사 전문기관 리얼미터가 지난 2월 25일부터 28일까지 전국 19세 이상 성인 2011명을 대상으로 실시한 차기 대선주자 선호도 조사결과 황교안 한국당 대표가 1위를 차지했으며 뒤이어 유시민 노무현 재단 이사장이 2위를 차지했다.	오마이뉴스 의뢰로 여론조사 전문기관 리얼미터가 실시한 2월 차기 대선주자 선호도 조사에서 1위 황교안, 2위 유시민, 3위 이낙연으로 나타나 황·유·이 3강 체제가 형성되었다.
육군은해·공군·해병대 학군장교 4000여 명이 충북 괴산 육군학생군사학교에서 2019년 대한민국 학군장교(ROTC) 임관식을 개최했으며, 이날 임관식에서 신임장교들은 각 군 병과별 보수교육 과정을 거쳐 일선 부대로 배치될 예정이다. 	지난 6일 개최된 2019년 대한민국 학군장교(ROTC) 임관식에 육·해·공군·해병대 학군장교 4000여 명이 '대한민국 장교'로 임관되었으며 지역 주민 등 2만 여 명이 참석하여 축하했다.
음식물 쓰레기를 처리하는데 드는 경제적 손실은 연간 20조 원에 달한다.	우리나라 사람들은 음식이 푸짐한 것을 좋아하지만 무분별한 음식물 쓰레기 배출은 경제적 손실 뿐만 아닐 환경오염도 야기하므로 '모자란 듯이', '조금 적은 듯이'가 습관화되어야 한다.
농림축산식품부는 전국의 만 18세 이상 일반여성농업인 1534명, 귀농 여성농업인 267명, 농촌지역 다문화여성 248명을 대상으로 '2018년 여성 농업인 실태조사'를 조사한 결과 여성농업인의 지위가 남성보다 낮다고 생각하고, 직업적 지위를 경영주로 인식하는 비율도 저조한 것으로 나타났다.	농림축산식품부가 발표한 '2018년 여성 농업인 실태조사'에 의하면 여성농업인 81.1%는 '여성농업인의 지위가 남성보다 예전보다 높지만 낮거나 여전히 남성보다 낮다'고 생각하고, 직업적 지위를 경영주로 인식하는 비율도 낮은 것으로 나타났다.
여주시는 민통선 일대의 야생멧돼지에서 아프리카돼지열병(ASF) 바이러스가 잇달아 검출됨에 따라, 선제적 포획으로 ASF 감염을 차단하기 위해 인원을 기존 30명에서 46명으로 16명 증원하고, 권역별 6개 조로 구성해 집중 포획에 나선다고 밝혔다.	여주시는 민통선 일대의 야생멧돼지에서 아프리카돼지열병(ASF) 바이러스가 잇달아 검출됨에 따라, 멧돼지 포획을 강화키로 했는데 시는 이번 조치가 선제적 포획으로 ASF 감염을 완전히 차단하기 위한 것이라고 설명했고, 이에 따라 시는 여주시 피해방지단원들을 대상으로 집중포획 강화 방안 및 총기 안전교육을 실시했다.
"김성해 연수구의회 의장은 지난 1년을 ""구민의 복리 증진을 위한 조력자 역할에 충실하고자 노력했던 한 해였으며 연수구의 미래를 책임질 다양한 사업이 차례로 시작되면서 연수구의 교통·교육·경제·문화 인프라가 확충되었다""고 돌아봤다."	김성해 인천 연수구의회 의장이 지난 1년간 연수구의 미래를 책임질 다양한 사업이 차례로 시작되면서 연수구의 교통·교육·경제·문화 인프라가 확충됐으며 구민과 소통하고 공감하는 열정의회가 되도록 최선의 노력을 다하겠다 말하며 '구민의 복리 증진을 위한 조력자 역할에 충실하고자 노력했던 한 해’라고 돌아봤다.
전남도는 9일 영암 호텔현대에서 한국무역협회 광주·전남지역본부 주관으로 제56회 무역의 날 수출탑 및 유공 포상자 전수식을 개최해 43개 기업·유공자를 시상했다.	제 56회 무역의 날을 맞아 전남도는 10억 달러 수출을 달성한 금호피앤비화학(주)를 비롯한 수출탑 27개사와 수출 유공 포상자 16명에게 전수식을 개최하였다.
김영록 전남지사는 지난 4월 김영록 지사를 비롯한 170여명이 경전선 전철화의 필요성을 알리기 위해 목포에서 부산 부전역까지 6시간 33분간 무궁화호를 직접 탑승한 행사에서 경전선 전철화의 국민적 공감대를 이끌어냈다는 평가를 받았다.	김영록 전남지사가 지난 4월 경전선 전철화의 필요성을 알리기 위해 목포에서 부산 부전역까지 운행하는 느림보열차 탑승 체험행사에 참여했던 참가자들에게 감사 서한문을 보냈다.
포스코 포항제철소가 지난달 31일 포스코 갤러리에서 지역 예술가들의 일상 속 예술 활동을 대중에 알리고자 기획된 문화체험형 수공예 장터인 예술시장 프리마켓을 열고 다양한 아트 상품을 선보였다.	포스코 포항제철소가 31일 포스코 갤러리에서 항해, 예술의 바달로 나아가자 일환으로 포항지역 예술가들의 예술 활동을 대중에게 알리고자 문화체험형 수공예 장터인 예술시장 프리마켓을 개최했다. 
롯데는 15일 롯데콘서트홀에서 '2019 롯데 팀장 콘퍼런스'를 개최하여 성과 창출을 위해 자신의 위치에서 최선을 다하고 있는 팀장들을 격려함과 동시에, 지난해 주요 경영 현황과 새해 경영 방향성을 공유하였다.	롯데그룹은 15일 롯데지주 대표이사를 비롯해 각 계열사에서 근무하는 팀장급 직원 1300여 명을 대상으로 개최한 ‘2019 롯데 팀장 콘퍼런스’에서 성과 창출을 위해 노력한 직원들을 시상하고 지난해 주요 경영 현황과 새해 경영 방향성을 공유했다.
천안시 알프스라 불리는 동남구 북면 오곡리에 자리한 위례초등학교가 학생들 야외활동이 많지 않은 계절이지만 지난 12월부터 학교 연못이 얼음썰매장으로 변신하며 인기를 얻고 있다.	천안북면 위례초등학교에서 지난 12월부터 학교 연못이 얼음썰매장으로 변신하며 전교생의 놀이터가 되었고, 많은 아이들이 이용했지만 사전 안전교육을 통해 한 건의 사고도 발생하지 않았다.
순창군 농업기술센터가 최근 농작물 병해충 방제와 작물 생육 증진에 우수한 기능성 미생물을 발굴해 주목을 끌고 있다.	순창군 농업기술센터가 최근 농작물 병해충 방제와 작물 생육 증진에 우수한 기능성 미생물을 발굴해 주목을 끌고 있으며 고추 작물을 대상으로 유용미생물의 고추 생육 증진 활성 연구도 활발히 진행해 친환경 농업 분야의 미래는 밝을 전망이다.
대선주조는 28일 서울 웨스틴 조선호텔에서 열린 ‘2019 대한민국주류대상’ 시상식에서 소주 17도 미만 부문 대상을 수상하는 영광을 안았는데, 올해는 20도 미만 부문 소주 중 가장 높은 평가를 받은 제품을 선정해 수여하는 ‘Best of 2019’를 동시 수상해 기쁨을 더했다.	대선주조는 28일 서울 웨스틴 조선호텔 그랜드볼룸에서 열린 ‘2019 대한민국주류대상’ 에서 대선소주로 소주 17도 미만 부문에서 3년 연속 대상을, 'Best of 2019'에서도 상을 동시에 수상해 2관왕을 차지했다. 
광주광역시는 최근 사회적 이슈가 되고 있는 감정노동자의 권리보호와 근무환경 개선을 위해 홍보대, 포스터를 시청 민원부서와 시 산하 공공기관 등에 배포했다.	광주광역시는 지난 2018년 10월18일부터 시행된 감정노동자 보호법에 따라 감정노동자의 권리보호와 근무환경 개선을 위해 홍보대 설치, 포스터 배포와 함께 감정노동자 보호교육을 시행할 계획이다.
자신의 지역구 예산이 의회 심의 과정에서 삭감되었다는 항의성 문자를 동료 의원에게 보낸 광주시의원이 공개 사과했다.	광주시의회 김익주 행정자치위원장은 7일 임시회 본회의에서 예산 삭감에 반발해 산건위 소속 의원들에게 항의 전화와 문자를 보낸데 대해 사과문을 읽어 공개 사과를 했다.
대전문화재단 차세대 아티스타에 선정된 오진주는 15일 오후 7시 30분 대전예술의전당 앙상블홀에서  '열정'과 '감정'이라는 테마답게 브람스의 바이올린 소나타 2번을 통해 봄바람에 이끌리듯 아름다우면서도 서정적인 선율과 그만의 활달하고 시원스런 연주를 선보인다.	15일 오후 7시 30분 대전예술의전당 앙상블홀에서 바이올리니스트 오진주는 'Passion & Emotion'를 주제로 연주회를 개최하며 브람스의 바이올린 소나타 2번, 풀랑의 바이올린 소나타 등의 연주곡을 선사한다.
경기도교육청은 학생과 학부모 및 교원들이 학교민주주의의 주요 요소인 ‘교권’과 ‘학생인권’ 분야에 대해 서로 상반된 평가를 내리는 등 갈등이 지속되고 있어 이에 대한 대책 마련이 절실하다.	경기도는 학교 구성원인 교직원과 학생 및 학부모들의 '교권'과 '학생인권' 분야에서의 갈등을 해결하기 위해 교권보호담당팀을 구성하고 인권실태조사 등의 정책을 추진하고 있지만 각 구성원의 인식을 변화시키는 데 어려움을 겪고 있어 대책 마련이 절실하다.
농림어업조사 결과 지난해 농축산물을 판매해 1억원 이상의 소득을 올린 농가가 경북 도내 7천277명으로 2015년 이후 4년 연속 전국 1위를 차지했으며, 억대 매출 분야별로는 축산 37%, 채소·산나물 24%, 논벼 15%, 과수 12% 등이고, 억대 농가수는 지난 2015년 4천788호, 2016년 5천673호, 2017년 6천433호에서 지난해 7천277호로 급증하였다.	"18일 경북도에 따르면 지난해 농축산물을 판매해 1억원 이상의 소득을 올린 농가가 경북 도내 7천277명(전국 농가의 20%)으로 4년 연속 전국 1위를 차지했다고 18일 밝혔으며 이는 체계적인 농업인 교육 진행과 시설 현대화로 생산량과 품질 경쟁력을 강화시켰기 때문이다.
"
광주광역시 동구가 민선7기 공약인 청년재정할당제 시행 1차 년도 시범사업으로 순수 구비 5천만 원을 내걸고 ‘2019년 동구 청년 상생비상 프로젝트’ 참가자를 공모하며, 신청자격은 동구에 거주하거나 동구 소재 재학·재직 중인 만 39세 이하 청년 3명 이상으로 구성된 팀 또는 단체면 신청이 가능하다.	광주광역시 동구는 청년이 직접 참여해 지역사회가 필요로 하는 사업을 개발·제안하고 프로젝트를 스스로 실행할 수 있도록 사업비를 지원하는 ‘2019년 동구 청년 상생비상 프로젝트’ 참가자를 공모한다고 28일 밝혔다.
당진시 보건소는 저소득 가정의 양육비 부담을 덜어주기 위해 자격 기준을 갖춘 만2세 미만의 영아를 둔 가정에 기저귀와 조제분유를 지원하고 있으며, 신청을 원하는 가정은 자격확인서와 증명서와 증빙서류를 지참해 보건소 또는 읍·면·동 행정복지센터에서 신청하면 된다.	당진시보건소는 자격 기준을 갖춘 가구에 대해 매월 기저귀 6만4천원, 기저귀 및 분유 동시 최대 15만원을 지원하는 지원사업을 진행 중이다. 접수는 보건소 및 각 행정복지센터에서 가능하며, 신청 문의는 보건소 모자건강팀 041)360-6080~4로 문의하면 세부사항을 안내 받을 수 있다.
2일은 날씨가 흐린 편이며 특히 중부와 남부 내륙에 소나기가 내리고 동해안은 낮 기온이 35도 이상 올라 매우 더울 것으로 예상한다.	2일 금요일에는 전국에 구름이 가끔 끼겠고 남부 내륙은 오후에 소나기가 내릴 것으로 관측되며 아침 최저기온은 22∼28도, 낮 최고기온은 30∼36도로 보일 것으로 예상되어 열대야 현상에 건강관리 조심해야 한다.
LG기 제27회 주부배구대회가 지난 27일 낙동강체육공원에서 참가선수들의 배구경기가 진행되는 동안 에어바운스 놀이터, 어린이 배구스쿨, 버블체험존, 어린이 LG팽이왕 선발대회 등 다양한 프로그램을 진행했다.	LG기 제 27회 주부배구대회가 올해 처음으로 낙동강 체육공원으로 행사장소를 변경해 봉사, 푸드트럭, 초청가수 공연 등의 다양한 프로그램으로 구성되어 열렸다.
어린이날(5월 5일)를 맞아 광주 국립광주박물관은 캐릭터 입체모자 만들기 등 체험형 문화행사와 삐에로의 풍선아트 등 먹거리 행사 등을 다채롭게 진행할 예정이다.	어린이날(5월 5일)을 맞아 국립광주박물관은 '어린이날 신나는 박물관 여행'을 개최하고, 광주문화재단은 가족 뮤지컬과 홀로그램쇼를 한 번에 감상할 수 있는 패키지상품을 선보이는 등 광주 지역 곳곳에서 다양한 문화행사가 열린다.
대구 시내버스 노사가 임금을 시급 기준 4% 인상하고 정년을 2년 연장하는 조건으로 극적 타결을 이루면서 버스대란이 피했지만 버스기사의 임금 상승으로 버스요금이 오르는 것은 아닌지에 대한 우려가 커지고 있다.	대구 시내버스 노·사가 버스 기사의 임금을 인상하고 경기도가 14일 일반 시내버스와 직행 좌석버스의 요금을 인상하는 등 버스 요금에 영향이 오는 것이 불가피해지면서 시민들이 버스 요금 상승에 대해 걱정하고 있다.
24일 GS취업포털 건설워커에 따르면 GS건설이 소프트웨어 엔지니어 분야 정규직 경력사원을 모집한다고 밝혔으며 지원자격은 직무별 자격요건과 모바일 어플리케이션으로 나뉜다.	GS건설이 소프트웨어 엔지니어 분야 정규직 경력사원을 모집하며, 데이터 플랫폼과 모바일 어플리케이션 직무를 나눠 채용할 예정이고 자세한 내용은 건설워커 홈페이지를 참고하면 된다. 
대구시청 여자핸드볼팀 컬러풀대구가 30일 대구시민체육관에서 열린 2018-19 SK핸드볼코리아리그 1라운드 서울시청과의 경기에서 26-23으로 2연승을 달리며 시즌 3승2패를 기록했다.	컬러풀대구는 30일 대구시민체육관에서 열린 SK핸드볼코리아리그 서울시청과의 경기에서 역전없이 26-23으로 이기며 2연승을 달렸다.
수원시는 지난 24일 시청 중회의실에서 ‘1월 중 확대간부회의’에서 올 한 해 동안 추진한 시책 7건을 ‘2019 시정베스트 7’로 발표하고 시상식을 진행한 결과, 무공해 전기버스 대규모 보급·충전 인프라 구축이 1위를 차지했고 ‘전국 최초 주민 거주지역 행정구역 경계 조정’, ‘미세먼지, 폭염 등 환경재난 대응 살수용수 확보’가 각각 2·3위로 선정됐다.	수원시에 따르면 ‘1월 중 확대간부회의’에서 ‘2019 시정베스트 7’를 발표 및 시상한 가운데 ‘무공해 전기버스 대규모 보급·충전 인프라 구축’이 1위로 선정되면서 2020년까지 전기버스 1천 대 도입을 목표로 삼았다.
전국통기타연합이 주최하고 당진통기타클럽(회장 박기성)이 주관한 47회 전국 통기타 페스티벌이 지난 11일 당진문예의전당 야외공연장에서 열렸으며 지역 주민들의 문화 향유 및 통기타 동호인들의 화합과 통기타 활성화를 위해 진행됐다.	당진문예의전당 야외공연장에서 전국통기타연합이 주최하고 당진통기타클럽(회장 박기성)이 주관한 47회 전국 통기타 페스티벌이 지난 11일 개최되었으며, 이 날 11개 팀이 페스티벌에 참가했다.
30일 스테로이드의 불법 거래 등을 다룬 실화탐사대인 스테로이드의 불법 거래 등을 다룬 실화탐사대인 스테로이드의 불법 거래 등을 다룬 실화탐사대에서 다양한 부작용이 존재한다고 밝혔다.	30일 방송된 MBC '실화탐사대'에는 소염제 등 의약품으로 사용되는 스테로이드의 불법 거래 실태와 스테로이드 오남용에 따른 다양한 부작용이 보도되어 화제가 되고 있다. 
의왕시 청계동 가막들공원에서 주민 500여명이 참여한 가운데 청계종합사회복지관을 중심으로 청계사, 청계장애인주간보호시설, 의왕시 건강가정·다문화가족 지원센터, 마켓발견, 청계보건지소, 청계자유발도르프학교 등 13개 민·관 단체 및 기관이 공동 참여해 다양하고 풍성한 마을축제로 거듭났다.	의왕시 청계동 가막들공원에서 주민들이 즐길 수 있는 '청계 올 가을축제'가 열렸고 식전행사와 2부 무대공연, 체험부스 등을 통해 축제 분위기를 한층 뜨겁게 달궜다.
경기도경제과학진흥원은 지난 27일 의정부 소재 경기벤처창업지원센터(이하 벤처센터)에서 창업기업의 데스밸리를 넘어 성공적으로 안착할 수 있도록 현장의 목소리 청취해 지원방안을 모색하고 성공사례를 공유하고자 '현장소통 간담회'를 진행했다.	경기도경제과학진흥원은 지난 27일 경기벤처창업지원센터에서 창업기업의 성공적인 안착을 위한 지원방안을 찾고자 입주기업 23개사가 참석한 '현장소통 간담회'를 개최했다고 29일 밝혔다.
2019남도 우수 원예작물 품질평가에서 장성 황금사과’가 대상을 수상했으며 올해 첫 수확에 성공한 '장성 황금사과'도 장려상을 수상했다.	장성군에서 재배한 포도 '샤인머스켓'이 원예작물 10개 그룹 31개의 작목 92점을 제치고 2019남도 우수 원예작물 품질평가에서 대상을 받았으며, 올해 첫 수확에 성공한 '장성 황금사과'가 장려상을 받았다.
충주시의회 박해수 의원이 14일 제231회 임시회 사전발언을 통해 수소 연료전지와 버금가는 수소저장장치 및 용기 산업도 충주 유치를 적극적으로 검토·추진해야 하며 수소차 충전소를 충주시청에 설치하고 당장 관용차량 및 시민 수소전기차 구입 보조를 대폭 확대해야 한다고 주장했다.	박해수 충주시의원은 제231회 임시회 사전발언을 통해 수소차 발전이 충주의 가능성 있는 유일한 미래산업이라는 점을 강조하며 수소차 생산 인프라를 적극적으로 유치해야한다고 주장했다. 
프로야구 KIA타이거즈와 기아자동차가 사회공헌 프로그램인 '타이거즈 러브투게더'의 10주년을 맞아 지난 1-2일 경기도 화성에서 취약계층 야구 동아리 4개 팀과 기아-YMCA 유소년 야구단의 연합 캠프를 개최하여 교류전과 레크리에이션, 레전드 특강, 놀이공원 방문 등의 프로그램을 진행했다.	타이거즈 러브투게더가 10주년을 맞아 취약계층 야구 동아리와 '야구로 즐기다'라는 주제로 진행된 연합캠프가 성료됐다.
세계김치연구소가 한국의 대표 발효음식인 김치의 문화·과학·발효 등을 직접 체험하고 이해하는 기획 특별전 '물 김치 페스티벌'을 광주김치타운에서 운영한다.	세계김치연구소는 2019광주세계수영선수권대회를 기념해 한국의 대표 발효음식인 김치를 전 세계인에게 널리 알리기 위해 ‘물과 김치의 만남’을 주제로 김치의 문화·과학·발효 등을 직접 체험하고 이해하는 기획 특별전 ‘물 김치 페스티벌’을 광주김치타운에서 운영한다고 밝혔다.
16일 통계청의 ‘5월 경제활동인구조사 청년층 부가조사’ 결과에 따르면 취업을 준비하는 청년층(15∼29세)이 올해 가장 많았던 것으로 분석됐다.	올해 통계청의 조사 결과 최종학교 졸업(중퇴)자 중 청년 미취업자는 154만 1천 명으로 2006년 조사 이후 최다를 기록했으며, 이들 10명 중 3명은 공무원 시험을 준비하는 것으로 나타났다. 
국토교통부는 28일 지자체 공모를 통해 부울경 지역에서는 처음으로 경남 진주시를 비롯한 전국 12곳(1313가구)을 선정했고 내년 착공한 뒤 2021년부터 입주자모집을 거쳐 순차적으로 입주를 진행할 예정이라고 밝혔다.	국토교통부는 65세 이상 저소득 어른신들이 주거와 복지시설을 함께 갖춘 공공임대주택인 '고령자 복지주택'이 경남 진주시를 비롯한 전국 12곳을 선정했다고 28일 밝혔다.
광주 송 민간공원 특례사업 2단계 대상지 중 하나인 송정근린공원에 대한 제안서 접수 재공고 결과, 제안서를 제출한 업체가 단 한 곳도 없어 사업추진에 제동이 걸렸다.	광주시의 민간공원 특례사업 2단계 대상지 중 하나인 송정근린공원이 다른 공원들과는 다르게 사업성이 떨어진다는 이유로 지원업체가 없어 사업 추진이 어려운 실정이며 시는 재정사업으로 진행하는 방법을 고려하고 있다고 전하였다.
한국동서발전은 4일 전남 영광군 염산면 영광풍력 발전단지 종합운영센터에서 국내 최대 규모인 140MW(메가와트)급의 ‘서해안 윈드팜(Wind Farm)’ 조성이 완료된 ‘영광풍력 발전설비 준공식’(사진)을 개최했다.	4일 전남 영광군 염산면 영광풍력 발전단지 종합운영센터에서 열린 '영광풍력 발전설비 준공식'을 시작으로 140MW급의 영광풍력 발전이 본격 가동되었으며, 동서발전은 2030년까지 국산 풍력발전기를 200기로 늘릴 계획이라고 밝혔다. 
전남도는 배산임수 지형인 완도수목원 지구를 국립에코난대식물원 유치 후보지로 결정하여 입지 여건, 지역 발전, 수목원 조성 및 유치 분야 등 4개 평가 항목에서 고르게 최고 점수를 받았다.	전남도는 국내 최대 난대림 집단 분포지인 전남도 완도수목원지구를 국립에코난대식물원 유치 후보지로 결정했다.
국립가야문화재연구소가 김해시 봉황동 유적에서 4~5세기에 제작되었을 것으로 추정되는 집모양 토기를 출토했다.	국립가야문화연구소는 9일 봉황동 유적에서 4~5세기 것으로 보이는 집모양 토기가 출토되었다고 밝히면서 흙으로 만든 사람이나 동물 모양의 상이 나온 점으로 집모양 토기가 의례용으로 사용됐을 가능성이 있다고 전했다.
대구시는 20일 호텔라온제나에서 '2019 물산업 아카데미 성과발표회'를 개최하여 물산업 시민강좌, 물산업 서포터즈 운영, 청소년 물 토크 콘서트 등  물산업 클러스터 조기 활성화를 위한 대시민 홍보 및 교육에 초점을 두었다고 밝혔다.	대구시는 20일 호텔라온제나에서 아카데미에 참여한 시민, 학생 등 200여 명이 참석하는 '2019 물산업 아카데미 성과발표회'를 열어 찾아가는 물산업 교육 등의 성과를 돌아보고 물산업의 미래가치에 대해 논의한다.
전남도해양수산기술원이 전남 수산물 생산 4조원 시대를 열기 위해 연구품종의 선택과 집중을 통해 어업인의 소득 향상에 기여하도록 연구 기능을 강화할 예정이다.	전남도해양수산기술원은 '미래 新 동력산업 및 연구기능 활성화'를 위해 4개의 방안 마련과 함께 전문지식과 경험을 갖춘 인재 채용을 확대하는 등 다각적인 계획을 수립할 계획이다.
최근 7년 연휴 교통상황을 바탕으로 설 연휴 기간 서울-부산, 서울-광주 고속도로의 교통량은 오전 7시를 기점으로 급격히 증가하여 오후 2시 최고조에 달하고, 오후 6시 이후 서서히 감소하는 패턴을 보일 것으로 예상되어, 모바일 내비게이션 업계들이 원활한 귀성, 귀가길 시간대를 예측해 눈길을 끌고 있다.	설 연휴 극심한 도로 정체가 예상되면서 SKT, 카카오 등 모바일 내비게이션 업계들이 빅데이터 분석 결과를 바탕으로 귀성길 골든타임을 예측해 눈길을 끌고 있다.
19일 정부서울청사에서 열린 제7회 국무회의에서 이낙연 국무총리는 행정안전부 세종 이전이 23일 마무리되고, 오는 8월 과학기술정보통신부도 세종청사로 이전한다고 발언하며 업무 비효율과 공직사회 활력 저하 문제를 해결하지 못하면 장관의 실천이 중요하다고 강조했다.	중앙부처의 세종시 이전 이후 업무 비효율과 공직사회 활력 저하 문제가 대두된 가운데, 19일 이낙연 국무총리가 정부서울청사에서 개최된 제7회 국무회의에 참석해 서울출장 등 비효율을 막기 위해선 장관의 실천이 중요하다고 강조했다
청와대에 따르면 한중일 정상회의가 연례적인 행사이긴 하지만 일본의 한국에 대한 수출 규제로 한일 관계가 최악으로 치닫는 상황임에도 한중일 정상회담 개최를 추진하고 있어 현 사태를 타개할 계기가 될 수 있을지 주목된다.	"청와대는 5일 한일 관계가 최악으로 치닫는 상황 속 한국과 중국, 일본 정부가 올해 12월 중국에서 3국 정상회담 개최를 추진 중이라는 외신 보도와 관련, ""시기를 조율 중에 있다""라고 밝혔다."
검찰 언론과 적폐 청산을 위한 광주시민행동과 광주·전남대학생진보연합은 12일 오후 광주 동구 금남로 인근 도로에서 '검찰개혁, 언론적폐 청산, 자유한국당 해체 광주시민 2차 촛불대회'를 열었으며, 집회 후 참가자들은 1시간50분가량 진행된 문화행사를 마치고, 광주 동구 지산동 광주 지방·고등 검찰청 앞으로 이동한 뒤 구호를 외치고 해산했다.	가칭 검찰개혁·적폐 청산을 위한 광주시민행동과 광주·전남대학생진보연합은 이날 오후 광주 동구 금남로 인근 도로에서 ‘검찰개혁, 언론적폐 청산, 자유한국당 해체 광주시민 2차 촛불대회’가 개최되었는데, 자유 발언에 나선 김성진 변호사는 “우리 검찰은 선진국과 비교하더라도 수사권, 수사지휘권, 자체 수사력, 기소독점주의, 기소편의주의, 공소 취소권을 모두 가지고 있는 등 강한 힘이 집중돼 있다”며 “힘의 분산·균형·견제가 필요하다”고 말했다.
전남도는 2019년 지방자치단체 정부합동평가 정성평가 부분 우수사례 평가에서 11건의 우수사례가 선정되어 도 단위 전국 2위를 달성했다.	31일 전남도는 2019년 지방자치단체 정부합동평가 정성평가 부분 11건의 우수사례가 선정되어 도 단위 전국 2위를 달성하고 행정안전부로부터 재정인센티브 지원과 유공자 포상을 받을 예정이라고 밝혔다.
르노삼성자동차는 설 명절을 앞두고 중소 부품협력업체에 물품대금 약 146억 원을 조기에 지급한다고 28일 밝혔다.	협력업체들과의 상생을 위해 꾸준히 노력하고 있는 르노삼성자동차는 설 명절을 앞두고 중소 협력사들의 자금 운영 부담 감소를 위해 다음 달 1일까지 중소 부품협력업체에 물품대금 약 146억 원을 조기에 지급하겠다고 28일 밝혔다.
근로자의날인 1일부터 2019년부터 근로장려금과 자녀장려금의 지원내용이 확대되고 지원대상 또한 확대되어 많은 사람들이 많은 혜택을 누릴 수 있을 것으로 예상되어 자녀장려금에 대해 함께 알아본다.	2019년 근로장려금과 자녀장려금은 오늘부터 국세청 홈페이지에서 온라인으로 신청조건 확인이 가능하며, 특히 5월 내 신청하지 못하면 지원금이 감액되므로 5월달 내에 홈페이지 및 전화, 앱을 통해 신청하는 것이 좋다.
정의당 심상정 대표는 21일 대표 취임 후 첫 기자간담회에서 더불어민주당과 단일화는 절대 없다며 선거제 개혁을 위해 노력하겠다고 밝혔다.	"심상정 정의당 대표가 21일 기자간담회에서 ""내년 총선 제1의 목표는 비례정당의 한계를 넘는 것이고, 더불어민주당과 단일화는 절대 없다""라고 당의 총선 전략을 밝혔다."
경남 거창군이 다음 달까지 기초조사를 한 뒤 오는 3월부터 지역 내 암 환자 70여 명을 대상으로 건강주치의제 서비스를 운영한다.	경남 거창군이 다음 달까지 기초조사를 한 뒤 오는 3월부터 지역 내 암 환자 70여 명을 대상으로 ▷말벗 ▷영양 식이지도 ▷가정방문 후 정보제공 ▷간단한 의료적 처치 등 보건·복지·의료팀이 함께하는 건강주치의제 서비스 운영을 전국에서 처음으로 시작한다. 
광주광역시는 2019광주세계수영선수권대회 기간 동안 선수촌과 남부대 주경기장에 광주관광안내센터를 특별 운영하여 관광지, 맛집, 홈스테이·공연 등 광주관광종합정보를 안내하고, 광주시티투어 및 수영대회 특별 투어 상품도 판매한다.	광주광역시는 2019광주세계수영선수권대회 기간 동안 선수촌과 남부대 주경기장에 광주광광안내센터를 특별 운영해 관광지, 맛집, 교통수단 등을 안내해 참가자 및 방문객들에게 편의를 제공한다고 밝혔다.
3.1운동 하면 가장 생각나는 인물로 '유관순 열사'가 48%의 압도적인 지지를 받으며 1위에 올랐고, 그 다음은 '대한독립만세'(29%), 4위는 '태극기'(5%), 5위에 '1919년'(4%)가 선정되었다.	3.1절 하면 떠올리는 것이 무엇인지에 대한 설문 조사 결과, ‘유관순 열사’ 관련된 것이 총 득표율 77%로 1,2위를 차지했다.
신안군 증도에서 개최되는 ‘2019 1004섬 신안국제시니어바둑대회’에서 60세 이상 16명의 기사들이 토너먼트 방식으로 초대 챔피언을 가린다.	오는 7일부터 12일까지 한중일 바둑의 전설인 서봉수, 린하이펑, 조치훈, 요다 노리모토 등이 출전하는 '2019 1004섬 신안 국제시니어 바둑대회'가 신안 엘도라도 리조트에서 열린다. 
10일 한국감정원의 주간 아파트 가격동향에 따르면 가을 성수기에도 하락세를 벗어나지 못하던 광주 아파트 매매가격이 이번 주에도 보합세를 보였으며 신규 단지 입주 영향으로 모든 자치구에서 대체로 안정세를 보이는 가운데 광산구·서구(0.01%)는 가을 이사철 수요로 소폭 상승했고,동·남·북구(0.00%)는 보합을 형성했다.	가을 이사철에도 불구하고 광주 아파트의 매매가격이 보합을 보였고 전세가격은 소폭 상승하였다. 
한국갤럽이 지난 22~24일 전국 성인 1002명을 대상으로 실시한 정당지지도 조사에서 더불어민주당의 지지도가 한 달만에 다시 40%선 아래로 주저앉았으며 이는 손혜원 의원의 목포 부동산 투기 의혹과 서용교 의원의 재판 거래 의혹으로 인한 것으로 분석된다.	95% 신뢰수준에 표본오차 ±3.1%포인트인 조사에서 손혜원 의원의 목포 부동산 투기 의혹으로 인해 더불어민주당 정당 지지도가 한 달만에 다시 40%선 아래로 하락했다.
KIA는 5일 광주기아챔피언스필드에서 열린 ‘2019 신한은행 마이카 KBO리그’ 두산베어스와의 경기에서 4-5로 패했다. 	KIA타이거즈는 5일 광주기아챔피언스필드에서 개최한 ‘2019 신한은행 마이카 KBO리그’ 에서 두산베어스에 4-5로 패배하여 4연패를 기록했다. 
SK 와이번스 2018시즌 SK 와이번스의 한국시리즈 우승을 이끈 트레이 힐만 전 감독이 8일 오후 SK의 스프링캠프가 열리는 베로비치의 히스토릭 다저타운을 방문하여 락커룸에 들어서며 마주친 코칭스태프와 프런트, 그리고 다저타운 관계자들과 반갑게 인사를 나눴다.	2018시즌 SK 와이번스의 한국시리즈 우승을 이끈 트레이 힐만 전 감독이 미국 플로리다주 베로비치에서 다시 SK 선수단을 만나 훈훈한 시간을 가졌다.
대구시가 2018회계연도 결산을 실시한 결과 채무비율과 부채비율이 매년 지속적으로 감소하는 기조를 유지한 것으로 나타났으며, 지방재정의 건전성을 판단하는 기준이 되는 채무비율과 부채비율이 매년 지속적으로 감소하는 기조를 유지한 것으로 나타났다.	대구시가 2018회계연도 결산 결과 지방재정의 건전성을 파악하는 기준인 채무비율과 부채비율이 매년 지속적으로 감소하고, 예산회계 결산액 잉여금 1조539억이 발생해 순세계잉여금이 6133억 원으로 집계되었다고 밝혔다.
진월면 선소리 산 5번지 일원에 토석채취 개발행위 관련 일부 마을이 몇 달째 허가 취소를 요구하며 반발하고 있다.	진월면 선소리 산 5번지 일원에 토석채취 개발행위와 관련하여 일부 마을 주민이 주민동의서가 대부분이 거짓 작성됐고 산사태가 우려된다며 허가 취소를 요구하고 있다.
통계청이 1인당 연간 노동 소득이 생산 가능 연령에 진입하는 15세부터 증가해 43세 때 정점에 달하고 그 이후 점차 감소하는 것으로 분석됐다.	통계청이 22일 국내 거주자의 1인당 연간 노동 소득은 2015년 기준으로 43세 때 연 2896만 원을 기록해  가장 많았고 생산 가능 연령에 진입하는 15세부터 증가해 43세 때 정점에 달하고 그 후 점차 감소해 58세부터는 소비보다 작아지는 것으로 분석되었다.
이승우는 지난 23일 살레르니타나와의 홈경기에서 선발로 뛰며 자신의 이름을 점차 각인시켜가고 있는 가운데, 이탈리아 매체 가제타 델로 스포르트는 26일 이승우가 지난 25라운드 세리에B에서 가장 우수한 선수인 레드불 B-베스트로 선정됐다고 전했다.	이승우가 지난 25라운드 세리에B에서 가장 우수한 선수인 레드불 B-베스트 선수로 선정되는 기쁨을 누렸으며, 27일 열린 26라운드 레체와의 홈경기에도 선발로 그라운드를 누비면서 최근 리그 3경기 연속 선발 티켓을 따며 이탈리아에서 자신의 이름을 각인시키고 있다.
순천만국가정원의 소형 무인궤도열차인 스카이큐브의 적자 문제를 두고 순천시와 업체 간 갈등이 길어지고 있는 가운데, 순천시는 중재 심판 이후 스카이큐브 운영에서 손을 뗄 경우 철거 비용을 업체가 부담해야 한다고 맞서 결과가 주목된다.	순천만국가정원의 스카이 큐브 적자 문제를 두고 3차심리가 연기되어 업체간 갈등이 장기화 될 전망이다.
양평군은 지난 28일 강상면 다목적복지회관 대회의실에서 주민공청회를 개최하여 2030년까지 양평의 미래 비전 로드맵을 설계하는 '7TH양평 수립을 위한 주민공청회'를 개최했다.	양평군은 지난 28일 강상면 다목적복지회관 대회의실에서 2030년까지 군의 미래를 위한 비전 로드맵을 설계하는 '7TH양평 수립을 위한 주민공청회'를 개최하여 6대 부문별 추진과제와 공동체 지원체계 구축 및 육성 등 15대 핵심과제와 관련한 전체적이고 구체적인 지향점에 대해 주민들과 토론을 진행했다.
광주시교육청이 3.1 운동 100주년을 맞아 친일 잔재물 전수 조사 및 청산을 위한 TF를 구성해 오는 28일 첫 회의를 개최한다.	"3·1 운동 100주년을 맞이하여 광주시교육청이 일선 학교에 있는 교명, 교패, 교기, 교목, 시설물 등을 조사하여 친일 잔재물인지의 여부를 판단할 계획이다.
"
전남도는 29일 2020년 경자년 쥐의 해를 맞아 전남 25개 가운데 15개가 섬 또는 해안가에 위치하며 쥐와 관련된 지명이 총 25개로 조사되었다고 밝혔다.	전남도가 2020년 경자년(庚子年) 쥐의 해를 맞아 전남 지명을 분석한 결과에 따르면, 쥐와 관련된 지명 전국 64개 중 39%(25개)로 가장 많은 규모이다.
산업통상자원부가 2040년까지 재생 에너지 발전 비중을 ‘30~35%’로 확대한다는 목표를 세우며 향후 20년간 중·장기 에너지 정책의 비전과 목표 등을 제시했다.	정부가 미세먼지 감축과 국가 경쟁력 제고를 위해 발전 단가가 원자력보다 3배 비싼 재생 에너지 발전 비중을 2040년 35%까지 확대한다는 방침을 정하면서 전기요금 인상이 예상된다.
광주세계수영선수권대회 조직위원회는 지난 4월 말 기준 참가등록을 완료한 마스터즈 대회 엔트리수가 64개국 3천200여 명을 넘어서고 있다고 밝혔으며, 대회 붐업 조성을 위해 국내외 수영연맹 및 수영 동호회 관계자들에게 등록 절차 안내 등 다양한 홍보 활동을 전개하고 있다.	8월 5일부터 8월 18일까지 열리는 제18회 2019광주FINA 세계마스터즈 수영선수권대회는 수영동호인이 참가하는 국제수영대회로, 현재 국제수영연맹 웹사이트를 통해 선수 등록이 한창 진행되고 있으며 등록인증을 완료한 참가자에게는 항공 및 대중교통, 문화예술공연 관람 등의 다양한 혜택이 주어지고 각종 행사 및 관광, 쇼핑 등 함께 즐기는 축제로 준비되고 있다.
지난 5일 당진시수영연맹 회장 이취임식이 신평 서해중앙신협에서 열려 원국희 회장이 이임하고, 조한규 회장이 취임하였으며 이들은 당진시가 종합 1위를 하는데 일익을 담당할 예정이다. 	당진시수영연맹 회장 이취임식이 지난 5일 신평 서해중앙신협에서 개최된 가운데 조한규 제7대 신임회장은 올해 열릴 도민체전에서 당진시가 종합 1위를 하는데 일익을 담당하겠다며 각오를 밝혔다.
대구시와 경북도는 ‘2019 서울국제관광산업박람회’와 연계해 대구·경북 관광 특별홍보관을 열고 세계 각국 축하 영상 메시지, 홍보대사 위촉, 해외 6대 핵심 여행사 업무협약 체결, 홍보영상물 상영, 대구·경북 글로벌 서포터즈 축하공연, 홍보 플래시몹 등을 진행한다.	대구시와 경북도가 코엑스에서 투어페스타와 관광의 해 선포식을 열고 다양한 행사를 통해 방문객들에게 볼거리, 즐길거리, 할인권 등을 제공할 예정이다.
광주시는 시장과 지역대표기업, 사회적경제기업 협의회 등이 참여한 가운데 ‘1사(社) 1사회적경제기업 파트너십 구축을 위한 업무협약’을 5일 체결했다.	광주시는 5일 시청에서 지역 대표기업, 사회적경제기업과 상생발전을 위한 ‘1사(社) 1사회적경제기업 파트너십 구축을 위한 업무협약’을 체결했다.
하남시가 교육부의 2019년 평생학습도시 지정에 발맞춰 시민 중심의 평생학습 환경을 조성하기 위해 다양한 사업을 전개하고 있다고 밝혔다.	하남시가 7일 시민 중심의 평생학습도시 환경 조성을 위한 주요사업 성과와 추진계획을 밝혔으며, 이광범 복지문화국장은 주민 주도형 평생학습마을 지원사업, 은퇴자 재교육 과정인 50+반반학교, 근거리 학습권 제공을 위한 빛나는 학습공간 등의 주요 사업에 대해 설명했고, 평생학습마을의 경우 경기도 지원 사업에서 5개 마을과 하남시 지원 사업에서 10개 마을이 참여하고 있다고 밝혔다.
영동군이 오는 5월 15일까지 104일간을 봄철 산불방지 대책기간으로 설정하고 산불전문진화대·산불감시원 운영, 산불 모니터링 등 종합적 산불 방지대책을 추진 중이다.	영동군이 지구 온난화 영향으로 건조일수가 늘어남에 따라 오는 5월 15일까지 봄철 산불방지 대책기간으로 정하고 산불감시원, 모니터링 등 종합적 대책을 추진 중이다.
오는 16일 한국은 UEFA 챔스 우승 경험 있고, 유로 2016년 예선 때 알바니아와의 홈경기에서 0-1로 패한 책임을 지고 사퇴한 파울루 벤투 감독은 이번 아시안컵에서 세계적인 명장 스벤 예란 에릭손(71), 마르첼로 리피(71) 감독과 지략 대결을 펼친다.	2019 아시안컵의 관전 포인트 중 하나는 에릭손, 벤투 감독등 유럽 출신 명장들이 벌이는 사령탑 자존심 대결이다.
신세계백화점이 새해 첫 세일부터 생활장르 대형행사를 열고 주방, 식기류, 가구 고객 수요 잡기에 나선다.	신세계백화점이 4일부터 20일까지 최대 70% 할인된 가격으로 이사, 결혼, 신학기 등 다양한 생활장르 수요를 선점하려는 행사를 진행한다.
고용노동부는 20일 지난해 실업급여 지급액이 2017년 같은 기간보다 1조4459억 원(27.6%) 증가한 6조6884억 원으로 잠정(이하 동일) 집계됐다고 밝혔다.	고용노동부는 2008년 이후 지급액이 6조7000억 원에 육박하며 사상 최대치를 기록한 실업급여 지급 증가에 대해 고용 악화, 최저임금 인상 등을 원인으로 꼽았다.
광주시 보건환경연구원은 올해 1월 본격 운영을 시작한 광주야생동물구조관리센터가 상반기에 총 42종 157마리의 야생동물을 구조했다고 29일 밝혔다.	29일 광주시 보건환경연구원은 올해 1월 본격 운영을 시작한 광주야생동물구조관리센터가 상반기에 총 42종 157마리의 야생동물 구조·치료는 지난해까지 구청별 지정 동물병원 5곳에 위탁해 연평균 120여마리 구조실적을 보였지만, 올해 야생동물 전문 ‘광주 센터’가 설치된 후 구조신고가 급증하고 있다. 
2일 더불어민주당 홍의락 의원은 포항산업단지 관련시설 내에 있어야 할 창고업 및 물류업종의 업체들이 불법으로 산업시설 내에 위치하고 있는 것으로 파악됐음에도 불구하고 이를 관리·감독해야 할 한국산업단지공단과 포항철강산업단지관리공단 등이 산단 내 불법 업종 변경에 대해 아무런 조치 없이 지난 10여 년 간 방치해 왔다고 지적했다.	"더불어민주당 홍의락 의원은 2일 ""포항산업단지 내 창고업 및 물류업종의 업체들이 해당 관리시설이 아닌 불법 산업시설 내에 위치해 있으며 한국산업단지공단과 포항철강산업단지관리공단 등의 관리당국이 이를 알고도 10년 간 방치했다""고 밝혔다."
의정부시 송산동 뺏벌 마을이 지난 4일자로 경기도가 건의한 뺏벌의 제한보호구역 전면해제에 적극적으로 논의하기로 했다고 지난 '2018년 하반기 경기도-제3야전군 사령부 정책협의회' 결과를 통보해왔다.	경기도가 '2018년 하반기 경기도-제3야전군 사령부 정책협의회' 결과, 군사시설보호구역(제한보호구역)으로 지정돼 개발이 제한됐던 의정부시 송산동 뺏벌 마을의 제한보호구역 전면해제에 대해 적극 논의하기로 했다.
구례 예술인마을이 25일 오전 10시부터 오후 5시까지 다양한 분야의 예술인 30명이 거주하고 있는 예술인촌으로 구례예술인마을 정기축제를 개최하며 다양한 작품 활동과 더불어 재능기부 등 지역 환원사업을 하고 있다.	귀촌한 예술가들이 거주한 지리산 근처의 구례 예술인마을은 구례군민과 함께 25일 구례예술인마을 정기축제를 열어 다양한 프로그램과 재능 기부 등을 보일 예정이다. 
가평군은 경기도 특별조정교부금 600억 원을 걸고 진행하는 ‘새로운 경기 정책공모 2019, 경기 First’ 사업 본선에 진출해 북한강 유역 ‘자라섬 수변 생태관광벨트 사업’을 제안하고 자라섬-남이섬 간 관광객 이동 동선을 개설하고 자라섬 남단 일대의 수변생태관광 목적지를 제정비하는 전략적 제휴사업 등을 추진해 북한강 관광산업의 시너지 효과를 낼 예정이다.	가평군이 28일 총 40억~100억 원씩 지원하는 ‘새로운 경기 정책공모 2019, 경기 First’ 사업에 ‘자라섬 수변 생태관광벨트 사업’을 제안하여 본선에 진출해 최소 40억여 원을 확보했다고 밝혔다.
tvN 새 월화드라마 ‘위대한 쇼’가 8월 26일 첫 방송되는 가운데, 전 국회의원 위대한이 국회 재입성을 위해 문제투성이 사남매를 가족으로 받아들이며 흥미진진한 이야기를 전개해 나갈 예정이다.	오는 8월 26일 첫 방송을 앞두고 tvN 새 월화드라마 ‘위대한 쇼’는 주인공인 송승헌의 파격 반전이 담긴 첫 스틸컷을 공개했다.
토트넘이 주축 주포들이 복귀했지만 오히려 역전패를 당하며 리그 무승 행진이 길어지고 있다.	시즌 내내 잘 나가던 토트넘이  ‘DESK’ 라인의 완전체 출격에도 오히려 역전패를 당하며 위기에 빠졌다.
‘악플의 밤’에 출연한 오마이걸 승희가 악플과 직접 대면해보고, 이에 대해 솔직한 속내를 밝히는 등 다사다난했던 악플사를 공개한다.	오마이걸 승희가 19일 저녁 8시 본인에 대한 악플을 의논하는 악플의 밤 5회에서 악플 체크를 통한 숨김없는 마음과 신념을 드러낸다.
인천지법 형사항소4부(양은상 부장판사)는 요양병원 복도에서 환자의 하반신을 노출한 채 기저귀를 교환하는 행위가 성적 학대에 해당한다고 판단해 무죄를 선고한 원심을 파기하고 벌금 50만 원의 선고를 유예했다고 7일 밝혔다.	"인천지법은 요양보호사 A씨가 요양병원 복도에서 환자의 하반신을 노출한 채 기저귀를 교환하는 행위는 성적 학대에 해당한다고 밝혔다.
"
부산경찰청은 지난달 31일 자로 일선 경찰 인사를 마무리하면서 정보 기능이 축소된 반면 여성·청소년 등 사회적 약자를 보호하는 기능이 대폭 강화되어 여성·청소년 등 사회적 약자를 보호하는 데 치안 역량을 집중하기로 했다.	부산경찰청은 업무 효율을 높이기 위해 유사한 기능의 정보과 조직을 축소하고 여성, 청소년 등 사회적 약자를 보호하는 일에 치안 역량을 집중 시켰다.
의정부시는 지역밀착형 안전순찰 활동, 쓰레기 투기 지역 감시 및 환경 정비 활동, 안전약자 보호 활동, 취약계층 복지 활동, 재난 위험 관리 활동, 생활불편 해소 활동을 중심으로 작년 12월 17일부터 지난 6월 30일까지 10명의 행복마을지킴이 및 사무원을 중심으로 주민들의 생활편의를 위한 활동을 진행했다.	의정부시는 지역밀착형 안전순찰 활동, 쓰레기 투기 지역 감시 및 환경 정비 활동, 재난 위험 관리 활동, 생활불편 해소 활동 등을 목적으로 설치한 의정부1동 ‘행복마을 관리소’ 운영을 새롭게 시작했다고 3일 밝히며, 주민들의 안전과 생활 편의를 위해 설치된 관리소인 만큼 앞으로 많은 주민들에게 도움을 주는 곳이 되기를 바란다는 뜻을 드러냈다.
경기도가 내년 도내 만 13∼23세 청소년들에게 지역화폐로 교통비 일부를 환급해 주는 정책 시행을 위해 교통비 부담 완화 대책 마련에 대한 도지사의 책무를 신설하는 등 조례 개정 작업에 착수했다.	경기도가 대중교통 이용 빈도 대비 경제적 자립도가 낮은 도내 만 13∼23세 청소년들의 교통비 부담을 완화해 주기 위해 내년부터 교통비 일부를 지역화폐로 환급해 주는 정책의 조례를 개정해 내년 1월부터 사업 시행에 나선다.
지난 6일 무역 관련 14개 기관이 모여 첫 실무회의를 개최하는 동시에 지역 내 5곳에 기업 피해 신고센터를 운영했지만 화이트리스트 제외로 타격을 받을 것으로 우려되는 인천 기업 현황을 파악·공유하기로 했으나 업종은 물론 업체 분류에도 애를 먹고 있다.	일본 수출규제로 인해 피해를 본 기업을 지원하는 업무를 하는 인천시 일본 수출규제 대응 태스크포스는 지원 기업의 다수는 지역본부이고 상급기관과 소통시 시간이 걸리기 때문에 적절한 역할 수행을 하지 못하고 있다. 
한국교육과정평가원은 2020학년도 대학수학능력시험의 출제경과를 분석한 결과에서 초고난도 문항의 출제는 지양하고 변별력을 확보하기 위한 고난도 문항은 필요하다고 밝혔다.	한국교육과정평가원이 초고난도 문항의 출제를 자제하고 검토위원의 난이도 예측 훈련을 강화하기로 함에 따라 11월 14일에 치뤄지는 2020학년도 대학수학능력시험는 불수능이었던 작년보다 쉽게 출제될 예정이다. 
수협 측은 구 노량진수산시장 자리를 비우는 작업이 2년여 만에 마무리되어 조만간 구청 측에 철거 허가 신청을 하고 본격적인 철거작업에 착수할 예정이다.	수협 측은 일부 시장 상인들과의 많은 충돌과 갈등이 있었던 구 노량진수산지장에 대해 2년여 만에 명도집행 대상 점포를 모두 폐쇄하고 조만간 철거작업을 시작할 예정이라고 밝혔다.
경기도는 지역개발사업 활성화를 위해 현재 1.75%인 지역개발기금 융자 이자율을 1.5%까지 인하하기로 결정했으며, 올해 말 종료 예정이던 지역개발채권 매입 감면 혜택을 1년 연장하고 5천만 원 미만 신규 자동차를 구입하는 도민에게 부여되는 채권매입 의무를 감면하기로 했다.	10일 경기도가 도내 시·군 지역개발사업 활성화를 도모하여 도민에게 장기적인 혜택을 주고자 지역개발기금 융자 이자율을 전국 최저 수준인 1.5%까지 인하하기로 했다. 
송산면 금암리에 위치한 당진갈릴리교회가 (사)국제독립교회연합회 사무총장을 맡고 있는 임우성 목사의 인도로 지난달 25일 입당예배 및 故이긍우 권사 기념선교센터 건립 기념식을 진행했다.	지난달 25일 당진 갈릴리교회의 입당예배 및 故이긍우 권사 기념선교센터 건립 기념식에서 박현식 지도목사는 초목회자 중심이 아닌 교인 중심의 교회로 거듭날 것을 강조하며 영농선교·복지선교·문화선교 등 3가지 목회 비전을 제시했다. 
대구시는 11일 오전 11시 대구 수성아트피아 무학홀에서 선조들의 자주독립정신을 기리는 대한민국 임시정부 수립 100주년 기념식을 진행했다.	대구시가 권영진 대구시장을 비롯한 320여 명이 참석한 가운데 선조들의 독립정신을 기리기 위한 대한민국 임시정부 수립 100주년 기념식을 진행했다고 밝히며 이 날을 기점으로 임정선열들의 숭고한 독립 운동정신을 이어받아 한반도의 평화·통일을 위해 노력하자고 말했다.
광주시는 일부 극우세력의 5·18민주화운동에 대한 역사왜곡이 날로 심해지고 있는 상황을 고려해 ‘5·18 역사왜곡 근절을 위한 홍보영상 제작’ 사업을 추진한다.	광주시가 5·18민주화운동에 대한 역사 왜곡이 심화하는 상황을 타개하기 위해 뮤직비디오 형식으로 홍보영상을 제작해 SNS상에 유포되는 역사 왜곡 영상물에 적극적으로 대응할 방침이다.
지난 9일 세종정부청사에서 나주시는 보건복지부가 주관하여 지난 9일 세종정부청사에서 열린 복지행정상 시상식에서 사회보장급여 사후관리 우수지자체에 선정돼 기관표창과 함께 대상을 수상했다.	나주시는 지난 9일 보건복지부 주관 2019년 지역복지사업평가 '사회보장급여 사후관리 부문'에서 대상을 수상했다. 
지난 18일 시청 회의실에서 정현복 광양시장을 비롯한 유관기관장과 200여 명의 직원이 참여한 가운데 방옥길 부시장 이임식을 가졌으며, 이임식에서 방 부시장은 “광양시가 대한민국 미래를 바꿔나갈 희망의 씨앗이 될 것이다”라고 소회를 밝혔다.	"광양시는 지난 18일 시청 회의실에서 국민권익위원회 청렴도 평가에서 1등급을 받는데 기여한 방옥길 부시장에게 공로패와 재직기념패를 전달하며 이임식을 가졌다. 


 "
전남도는 '낭만 가득 남도의 아름다운 섬'으로 지정된 보성 장도, 신안 비금도, 도초도 3개의 섬을 8월 추천관광지로 소개했다.	전남도는 8월 추천 관광지로 보성 장도, 신안 비금·도초도 3개의 섬을 소개하며  “‘낭만 가득’ 남도 섬에서 휴가 즐기세요”라고 말했다.
부천문화재단 시민미디어센터에서 운영하는 판타스틱큐브는 부천시청 1층에 위치한 총 70여석 규모의 독립영화 전용관으로 <이월>, <메이트>, <얼굴들>, <시인할매> 등 기존 독립영화도 쉽게 지나칠 수 없는 재미를 갖고 있다.	부천문화재단은 2월을 맞이해서 오는 16일까지 독립영화 전용관인 '판타스틱큐브'에서 <이월>, <메이트>, 등 다양한 신작 독립영화를 선보일 예정이다.
30일 광2020시즌 새로운 도약을 준비하는 프로축구 광주FC가 후원사 및 파트너를 모집한다고 밝혔으며 미디어분석 전문업체 (주)더폴스타가 광주의 2019시즌 브랜드 노출(TV 중계 및 뉴스·포털사이트·SNS·경기장 광고 등)을 분석한 결과 광고 효과가 68억 원으로 나타났다고 밝혔다.	광주 FC는 지난 30일 후원사 및 파트너를 모집한다고 밝혔다.
한약진흥재단이 그간 한약재로 사용되는 현초를 대상으로 항산화, 항염증의 효능 및 성분을 분석한 결과 관절염과 위염에 뛰어난 것으로 확인되었고 앞으로 우수한 한약재를 발굴해 농가 소득에 기여할 수 있도록 노력할 예정이다.	한약진흥재단은  한약재 30품목에 대해 항산화 활성을 평가했으며, 이 중 현초가 가장 우수한 효능을 보인 것을 확인할 수 있었는데 관절염과 위염에 효능이 있고 질병의 원인인 활성산소를 제거하는 능력이 있어서 추가 연구를 진행하고 있다.
9일 한국무역협회에 따르면 해외 온라인 소비자들이 한국에서 가장 구매하고 싶은 품목으로 화장품·향수 등 'K뷰티'를 꼽았다.	9일 한국무역협회에 따르면 해외 온라인 소비자들이 한국에서 가장 구매하고 싶은 품목으로  화장품·향수 등을 꼽았으며  ‘사후관리’와 ‘배송’은 다소 낮은 평가를 받았다.
경산시가 사회 각계각층에서 왕성한 활동으로 경산을 빛내고 있는 출향인사를 발굴해 명예 읍·면·동장에 위촉하는 위촉식을 진행했다.	경산시가 사회 각계각층에서 왕성한 활동으로 경산을 빛내고 있는 출향인사를 발굴해 명예 읍, 면, 동장에 위촉하는 위촉식을 진행하였고, 위촉된 15명의 명예 읍면동장은 역발전을 위한 다짐과 각오를 공고히 하였다.
복음자리에서 한국인이 선호하는 과일 1순위*인 '사과'를 활용한 '45도 과일잼 사과버터'와 '45도 과일잼 사과버터'를 새롭게 선보였으며 과일 본연의 맛과 향, 색, 식감을 살린 45도 과일잼 사과버터도 출시 예정이다.	과일가공 전문 브랜드 복음자리가 국산 사과만을 재료로 사용하여 과일 본연의 상큼한 맛과 아삭한 식감을 느낄 수 있는 '45도 과일잼 사과'와 사과와 버터를 함께 사용한 '45도 과일잼 사과버터' 2종을 출시했다.
대전지역 문화예술계는 대전방문의 해를 맞아 대전역 주변 야시장 운영과 K-POP 뮤직 페스티벌, TEN-TEN 프로젝트 등을 개최하지만 1회성 반짝 행사가 아닌 대전의 문화 예술을 관광객들에게 알리고 각인시킬 수 있는 상설, 수시 프로그램 등이 보완돼야 한다는 목소리가 높다.	대전 방문의해를 맞이하여 진행되는 주요한 사업에 대전지역 문화예술계가 참여할 자리가 많이 없어 프로그램의 보완이 필요하다는 주장이 나왔고 이에 대해 대전시 역시 지역 예술인들이 참여할 수 있는 기회가 많이 제공되어야 한다는데 동의했다. 
파주시가 12∼13일 1박 2일간 국내 대학교에 재학 중인 외국인 유학생을 초청해 한국의 전통문화와 DMZ 자연환경을 간접적으로 체험하게 하는 관광 활성화 팸투어를 실시한다.	파주시는 파주의 관광 자원을 알리고 평화 관광 활성화를 위한 올해 두 번째 팸 투어를 12~13일 양일간 국내 거주하는 외국인 유학생을 초청하여 실시한다.
음성군은 2019년 예산기준 지방재정 운용상황을 지난달 28일 음성군 홈 페이지에 공시하였는데, 이는 지방자치단체가 재정운용계획과 재정에 관한 지역주민의 관심사항 등을 관련 법령에 따라 2월(당해연도 예산)과 8월(전년도 결산)에 연중 2회 공시하고 있기 때문이다.	지난달 28일 음성군은 2월(당해연도 예산)과 8월(전년도 결산)에 연중 2회 공시하는 2019년 예산기준 지방재정 운용상황을 공시하였으며 전년대비 380억 원이 증가한 수치인것이 드러났다.
세월호 참사 발생 5년 7개월 만에 각종 의혹을 재수사하는 '세월호 참사 특별수사단'이 어제 출범했으며, 임관혁(53) 수원지검 안산지청장이 단장을 맡은 특수단은 수사 기록을 넘겨받아 본격적인 수사에 나선다.	임관혁 수원지검 안산지청장이 단장을 맡은 세월호 참사 특별수사단이 어제 출범하여 기존 기록과 내용을 종합해 수사 방향을 검토하겠다고 발표했다.
인천시는 ‘인천시 온라인 시민청원’ 사이트는 지난해 개설 이후 열 달째인 9월 말 현재 총 888건의 청원이 등록되었으며 이 중 미성립 청원에 대한 부서답변율도 50%에 이른다고 밝혔다.	LNG 기지 인근 해상쓰레기 매립지에 관한 인천시의 입장을 선언해 달라는 청원이 2천5명의 공감을 얻어 공식 답변 기준인 3천명을 넘지 못했는데도 이에 대해 해상매립지 조성계획이 없다고 두 차례나 밝혔던 인천시가 지역 주민들의 반발과 혼란이 계속되자 또다시 공식 입장을 밝혔다.
고흥군은 달, 토성, 목성을 관측할 수 있는 천체관측의 최적기로 꼽혀 오는 27일부터 8월 18일까지 여름 휴가철을 맞아 고흥우주천문과학관에서 특별 프로그램을 운영한다고 밝혔다.	고흥군은 고흥우주천문과학관에서 천체관측의 최적기인 27일부터 8월 18일까지 달, 토성, 목성 모두 관측할 수 있는 특별 프로그램을 운영한다고 밝혔다.
문재인 대통령은 한·아세안 특별정상회의와 한·메콩 정상회의의 성공적개최를 위해 아세안 국가들의 협력을 당부하고 한·아세안 정상회의와 한·메콩 정상회의의 개막을 20여 일 앞두고 한자리에 모인 아세안 국가들의 협력을 재확인함으로써 정부의 핵심 외교정책인 신남방정책의 확대·심화를 위한 기반을 다질 수 있게 됐다.	문재인 대통령은 각국 정상이 테러, 기후변화, 재난관리, 미래 인재양성에 긴밀히 협력하기로 한 아세안+3(한중일) 정상회의와 동아시아정상회의(EAS)를 마치고 귀국하였는데 전날 아베 신조 일본 총리와 별도의 환담을 가지고 관계 개선을 모색했다.
2019년 광주전남농협 수출협의회 정기총회 개최해 광주·전남만의 특색있는 수출유망 품목 발굴 및 수출 전문조직 육성방안을 모색한 농협지역본부는 29일 영암농협 2층 회의실에서 광주·전남수출농협 조합장 등 40여명이 참석한 가운데 '2019년 광주전남농협 수출협의회 정기총회'를 개최하고 지역 농산물 수출 단지화에 최선을 다할 것을 결의했다.	농협지역본부는 29일 영암농협 2층 회의실에서 광주·전남 33개 수출농협  조합장 등 40여명이 참여한 와중에 수출협의회 정기총회를 개최하여 2018년 사업결산, 2019년 사업계획 등을 논의하고 전남농협의 성장을 위한 수출품종 방안을 모색했다. 
오는 27~28일 열리는 제2차 북미정상회담의 결과에 따라 남북 관계를 높은 단계로 진전시킬 새로운 전기로 간주하고 있는 반면 제1야당인 자유한국당은 '완전한 비핵화'가 성과로 나와야 한다고 주장하여 기대와 주문 등에서 크게 엇갈리고 있다.	제 2차 북미정상회담을 앞두고 더불어민주당은 이번 회담이 한반도 평화를 위한 마지막 기회라고 주장한 반면, 자유한국당은 '완전한 비핵화'가 최우선이라는 입장으로 여야의 입장차가 뚜렷하다.
국민경제자문회의, 경제사회노동위원회, 소득주도성장특별위원회가 9일 서울 포스트타워 대회의실에서 문재인 정부 2년, 경제·노동 정책의 성과와 과제 라는 주제로 열린 정책 토론회에서 참석자들은 소득주도성장이 일정 부분 성과를 거뒀다고 평가하면서도 일자리 창출 등에서 어려움을 겪었다고 자성을 이어갔다.	대통령 직속 기구들은 '문재인 정부 2년, 경제 노동 정책의 성과와 과제'라는 주제로 정책 토론회를 열었으며 이들은 일자리 창출 관련 정책에서는 여전히 어려움을 겪고 있다고 토로하였으며 특히 최저임금 인상과 노동시간 단축 문제가 노사관계를 악화시켰다고 평가하였다.
2019년 설날이 다가오면서 직장 상사나 선배에게 인사하는 문구가 애매하다는 반응으로 새해 행운을 빌어주는 방식에 대한 관심이 높아졌다.	"직장 상사나 선배에게 새해 복 많이 받으라는 인사말이 식상하다면, ""해피 뉴 이어"", ""신 니엔하오"" 같은 외국어를 동원하는 것이 좀 더 특색있는 인사가 될 수 있다."
대구 동구구청은 도동문화마을 커뮤니티센터 건립 공사를 올해 중으로 시작하여 내년 6월께 완공할 예정이다.	대구 동구청은 지역 문화를 소개하는 도동문화마을 커뮤니티센터의 건립공사를 올해 착공해 내년 6월내로 마무리할 방침이며 이 센터를 통해 지역 문화 홍보 뿐 아니라 인근 지역경제도 활성화 될것으로 기대하고 있다.
인천은 선수단이 제100회 전국체육대회에서 목표로 한 종합순위 7위(광역시 1위)보다 좋은 종합 5위(광역시 1위)에 올랐지만 대회 폐회일인 10일 금 2개를 추가, 최종 금 58개, 은 57개, 동메달 98개, 총득점 3만7천223점으로 지난해(금 55개, 은 67개, 동 92개·3만7천557점)보다 금메달 1개를 더 땄다.	인천시선수단은 제 100회 전국체육대회에서 총득점 3만7천223점을 획득해 2014년 제주 전국체전 이후 5년 만에 종합 5위에 올랐다.
양진철(57) 지방이사관이 2년간의 용인시 제1부시장 직무를 성공적으로 수행하고 1일자로 부천시 부시장으로 자리를 옮겼다.	행정학 전공 및 행정정책관리학 석사학위를 취득하고 행정고시 합격 및 하남·양주·남양주·안산시 등에서 부시장을 역임한 양진철 지방이사관이 부천시 부시장으로 자리를 옮겼다.
당진시는 2018년 5개 지역에서 시범 실시한 주민총회 사업을 올해 14개 읍·면·동 전지역으로 확대한다.	당진시가 마을사업 안건을 지역주민 1% 이상이 모인 주민총회에서 공론화해 실행할지를 주민이 직접 선택하는 주민총회 사업을 올해 14개 읍·면·동 모든 지역으로 확대 실시하는데, 이는 최초로 도심과 농촌에 모두 직접 민주주의를 실현하는 사례다.
국토교통부는 지문이나 손바닥 정맥 등 생체정보를 미리 등록해 놓고 공항에서 인증하면 주민등록증이나 운전면허증 등 신분증 없이도 출국할 수 있는 생체정보 신원확인 서비스를 연내 도입할 계획이다.	7일 국토교통부는 ‘2019년도 업무보고’를 통해 지문·손바닥 정맥 등 생체정보 신원확인 서비스를 올해 내에 인천공항 국제선 노선으로 확대하는 내용의 이용객 편의 개선 방안을 밝혔다.
그간 가덕도 신공항 건설에 부정적이던 대구·경북(TK) 지역의 숙원사업인 대구공항 통합이전이 이뤄지면 더는 가덕도 신공항 건설을 반대할 이유가 없을 것이란 판단에서다.	정부가 올해 안에 대구공항 통합이전 최종 부지를 선정하고 관련 절차를 신속하게 추진하면서 대구공항 통합이전에 속도가 붙자 대구·경북(TK)도 가덕도 신공항 건설을 반대할 이유가 없어져 가덕도 신공항 논의에도 청신호가 켜질 전망이다. 
야당은당은 인사파일을 들고 참모총장과 인사 대상자를 바깥 카페에서 만나는 것에 대해 코미디 같은 일이라며 연일 청와대발 의혹을 제기하고 있는 가운데, 여당인 더불어민주당은 말을 아끼면서도 당혹감을 감추지 못하는 분위기다.	자유한국당과 바른미래당은 7일 청와대 행정관이 군인사에 개입한 것에 대해 문제를 크게 삼아 비판했으며 더불어민주당은 이에 대한 당혹감을 표했다. 
MBC 'USIC과 MBC every1에서 방송된 '창작의 신: 국민 작곡가의 탄생'(이하 '창작의 신')에서 노윤호는 중독성 있는 후렴구가 돋보이는 댄스곡 '목말라(Thirsty)'를 선보였으며, 심사위원들은 이정환과 딕펑스가 에너지 넘치는 라이브 밴드 음악 'DANCE'를 선보였다고 전했다.	20일 MBC MUSIC과 MBC every1에서 방송된 '창작의 신'에서 4차 오디션 '콜라보 미션'을 통과한 5명이 27일 세미 파이널 '편곡미션'에 출전해 톱3를 가린다.
광주시는 성장잠재력과 일자리 창출, 지역사회 공헌도 등이 우수한 16개사를 ‘광주시 스타기업’으로 선정, 육성할 계획이다.	광주시는 성장잠재력이 높은 기업을 지원해 강소기업으로 육성하기 위한 사업인 스타기업 육성사업에서 16개 회사를 선정해 기업 맞춤 전용 프로그램을 지원한다. 
광주시는 지난 13일 시청 3층 중회의실에서 광주대표음식 선정위원회를 개최하여 애호박과 팥 칼국수를 제외한 8개 음식을 광주 미래 전략음식으로 최종 선정했다.	광주시는 광주대표음식 선정위원회를 개최하여 광주 대표음식 9가지 후보군 중 8개 음식을 최종 선정하였고, 100인 토론회를 거쳐 상징성, 차별성, 대중성 등 3개 부문 음식을 주먹밥, 상추튀김, 무등산 보리밥으로 최종 확정하고 광주 미래 전략음식으로 육성한다고 밝혔다.
우리나라 4월 경상수지가 83개월만에 적자를 낼 것으로 예상되는 가운데 대구시는 지역 내 12개 수출유관기관들과 함께 '긴급 수출비상대책회의'를 열어 수출 부진 장기화 전망에 따른 기업 지원 대책에 대해 함께 논의할 예정이다.	우리나라 4월 경상수지가 83개월만에 적자가 예상되는 가운데 대구지역 수출 또한 3개월 연속 하락세를 보이면서 비상이 걸려, 대구시는 4일 대구시청 대회의실에서 수출유관기관들과 함께 긴급 수출 비상대책회의를 개최하여 대책을 논의할 예정이다. 
광양 출신 김유진씨가 지난달 30일 진주시에서 개최된 제68회 개천예술제 전국국악경연대회에서 일반부 성악 대상을 수상했다.	광양 출신 김유진씨가 지난달 30일 진주시에서 개최된 제68회 개천예술제 전국국악경연대회에서 소리가 탄탄하고 목소리가 곱고 공력이 있다는 평과 함께 99점 만점으로 성악 일반부에서 대상을 차지하였다.
‘전쿄올림픽 욱일기 퇴치 캠페인’을 꾸준히 펼치고 있는 성신여대 서경덕 교수는 AP, 로이터 통신, 뉴욕타임스, 워싱턴포스트, 인민일보, 르몽드 등 전 세계 주요 언론 32개 매체에 ‘도쿄올림픽 욱일기 응원 허가’에 관한 제보 메일을 발송했다고 18일 밝혔다.	서경덕 교수가 전 세계 주요 언론 32개 매체에 도쿄올림픽 욱일기 응원 허가에 관한 메일을 발송하여 욱일기 사용의 문제점들을 짚어주었다.
2017년 입학 후 국제보건 리더십 함양을 위해 페루 도시빈민지역에서 진행된 SK 대학생 자원봉사단 SUNNY 리더그룹 활동을 통한 베트남 환경개선프로젝트 및 국내 취약계층을 위한 다양한 활동을 적극적으로 기획하고 참여한 이시윤씨가 '2019년 광주광역시 청소년 대상' 국제화 부문 시장 표창을 수상했다.	호남대 간호학과 이시윤씨가 2018년 입학 후 페루에서 진행된 간호학과 글로벌리더십 프로그램 참여를 계기로 다양한 활동을 기획하고 참여한 공적을 인정받아 '2019 광주광역시 청소년 대상' 국제화 부문 시장 표창을 수상했다.
문재인 대통령이 인사청문회를 거친 장관 후보자 7명 중 지명철회하거나 자진사퇴한 2명을 제외한 나머지 5명의 장관 후보자들에 대해 방미전을 임명하기 위해 수순에 돌입했으며, 야당인 한국당은 물론 바른미래당도 박영선 중소벤처기업부·김연철 통일부 장관 후보자에 대한 임명을 반대하고 있어 청와대와 국회간 대립이 한층 격화될 것으로 우려된다.	문재인 대통령이 최근 국회 인사청문회를 거친 대상 7명 중 지명철회하거나 자진사퇴한 2명을 제외한 나머지 5명의 장관 후보자들에 대해 방미전인 4월 10일 임명하기 위한 수순에 돌입한 가운데, 한국당과 바른미래당이 박영선 중소벤처기업부, 김연철 통일부 장관 후보자의 임명을 반대하고 있어 문 대통령이 임명을 강행할 경우 청와대와 국회간 대치 상황이 우려되며 청와대는 아직 청문보고서가 채택되지 않은 3명에 대한 청문보고서 송부를 재요청하는 방침을 검토중인 것으로 알려졌다.
전국 시도교육감협의회는 19일 보도자료를 내고 공당의 국회의원들이 숭고한 5·18의 역사를 왜곡·폄훼한 것에 깊은 유감을 표하며 전국 모든 학교에서 민주주의 역사교육을 하겠다고 밝혔다.	전국 시도교육감협의회는 19일 보도자료에서 국가기념일로 지정되고 관련 자료들이 유네스코 세계기록문화유산에 등재된 5.18 민주화운동의 진실과 정신을 전국 모든 학교에서 바르게 교육하기 위해 지원과 협조를 강화하겠다고 밝혔다.
광주광역시 북구가 광주·전남 관광자원을 연계한 상품을 개발하여 남도관광의 거점이 되도록 팸투어를 진행한다.	광주광역시 북구가 오는 15일부터 16일까지 전국 여행사 대표 등 여행업 관계자 40여명을 초청해 남도의 관광지나 여행상품을 홍보하기 위해 남도여행 팸투어를 진행하여 광주·전남 관광자원을 연계한 상품을 개발, 남도관광의 거점 역할을 수행해나갈 계획이라고 밝혔다.
27일 대구시의회에 따르면 대구권 군위·안동축의 광역교통여건 개선을 위해 3천203억 원을 투입해 2024년까지 연장 9.7km, 폭원 4차로의 도로를 신설하는 사업이 최종 예비타당성 조사를 통과해 대구 도심에서 칠곡군까지 통행시간이 20분 이내로 단축된다.	교통정체 해소를 위해 3천 203억 원을 투입하여 대구 북구 조야동과 경북 칠곡군 동명면을 연결하는 조야~동명 광역도로 건설사업의 심의가 27일 통과했다.
현대건설은 13일 수원체육관에서 열린 프로배구 ‘도드람 2018-2019 V리그’ 여자부 4라운드 홈 경기에서 외국인선수 마야와 국가대표 센터 양효진이 53점을 합작하고, 센터 황민경, 고유민이 안정된 수비를 펼쳐 3위 화성 IBK기업은행에 세트스코어 3대1 역전승을 거뒀다.	지난 13일 현대건설은 수원체육관에서 개최된 '도드람 2018-2019 V리그' 홈 경기에서 IBK기업은행을 꺾고 3연승을 달리며 반격의 서막을 알렸다.
지난 10월30일 대한주택건설협회 대구시회 제9대 회장에서 10대 회장으로 연임한 노기원 태왕 대표이사 회장은 지역 업체의 경쟁력 강화를 통한 지역 경제 활성화를 위해 업계는 물론 대구시와 시민, 지역 금융기관이 모두 함께 노력해야 한다고 강조했다.	지난 10월 30일 노기원 태왕 대표이사는 대한주택건설협회 대구시회 제10대 회장으로 연임하게 되었는데 회장은 주택건설부문 업체의 경쟁력이 뛰어나나 자금력이 부족해 지역업체들의 시장에서 외면 받는 현실이 안타깝다며 대구 지역 회원사를 위한 소임을 다하는 회장이 되겠다고 밝혔다.
충북대학교 농업기술원은 이화여자대학교 2018학년도 전기 학위수여식에서 연구·지도직 공무원 3명이 주경야독의 노력으로 박사 학위를 취득하였으며 이채영 농업연구사(40)로 2013년 박사과정에 입학하여 6년 만에 '흑미 품종의 재배방법에 따른 생육 및 이화학적 특성'이란 제목의 논문으로 농학박사 학위를 취득하였다.	"26일 충북도농업기술원은 충북대학교와 이화여자대학교 2018학년도 전기 학위수여식에서 이
채영 농업연구사, 김기현 농업연구사 등 공무원 3명이 박사 학위를 취득했다고 전했다."
대구동인초등학교는 한국과학창의재단 대학생 교육기부프로그램을 활용해 지난 7일부터 9일까지 3일간 쏙쏙캠프를 운영했다.	대구동인초등학교는 겨울방학을 맞아 한국과학창의재단 대학생 교육기부프로그램을 활용해 6명의 대학생 팀이 초등학교에 찾아가 다양한 체험 프로그램을 기획, 운영하는 쏙쏙캠프를 지난 7일부터 9일까지 운영했고, '음식여행을 떠나요!'를 테마로 푸드테라피, 크리에어터 체험 등을 진행했다.
상수도관 노후화로 최근 10개월 동안 3차례나 파열됐지만 교체 사업이 속도를 내지 못하면서 시민들이 큰 불편을 겪고 있다.	"최근 10개월간 3차례 노후된 상수도관의 파열로 대구 시민들이 교통 통제와 단수 등 큰 불편을 겪자, 상수도본부 관계자는 ""노후가 심한 상수도관부터 최대한 빨리 교체하겠다""라고 해명했다."
19일 대구 중구 대보상가 4층 사우나에서 발생한 불은 소방 출동 20분 만에 진화됐지만, 화재 장소가 완전히 밀폐된 사우나인 점, 탈의한 상태에서 무방비로 노출된 점 등 여러가지 요인이 복합적으로 작용해 인명피해를 키웠다.	대보상가는 1980년 지어져 스프링클러 관련 소방법 적용 대상에서 제외되며 건물 노후화와 목욕탕이라는 특수성이 맞물려 초동진화에 실패해 피해 규모를 키운 것으로 분석된다.
국립아시아문화전당이 아시아문화원(ACI)과 8월 1일부터 15일까지 여름방학 청소년을 위한 ‘보물책 찾기’ 프로그램을 ACC 라이브러리파크에서 개최한다.	보물책의 청구기호를 힌트 삼아서 국립아시아문화전당의 라이브러리파크 서가 곳곳에 숨겨져 있는 보물책 10권을 찾아야하는 '보물책 찾기' 이벤트가 개최되며 성공하면 특별한 선물을 받을 수 있다.
14일 한국음식관광협회 광주지회에 따르면 한국김치팀은 지난 8일부터 11일까지 양재동 aT센터에서 열린 제20회 한국국제요리경연대회 전통음식전시 부문에 참가해 광주김치, 내림김치, 북한김치 등 100여종을 전시하여 대통령상을 수상했다.	14일 한국음식관광협회 광주지회에 따르면 지난 8일부터 11일까지 양재동 aT센터에서 열린 제20회 한국국제요리경연대회 전통음식전시 부문에서 김지현 외 26명으로 구성된 한국김치팀은 대통령상, 김영옥 외 22명으로 구성된 발효음식팀이 건복지부장관상을 수상했으며 한국김치팀은 광주김치, 내림김치, 북한김치, 식초 등 100여종을 전시 했는데 그 중 광주김치와 내림김치, 북한김치 등이 큰 호응을 얻었다.
익산시는 닭고기 전문업체인 하림을 비롯한 식품기업을 중심으로 2024년까지 2000개의 일자리를 창출하겠다는 계획을 발표했고 이에 따라 일자리 모델에 참여하는 기업의 경우 지역에서 생산된 식품 원료를 우선하여 구매하고 농가 및 협력업체와 일정 수준 이상의 단가 및 계약 기간을 유지하며 일자리 창출을 촉진할 계획이다.	익산시는 지역의 식품기업과 함께 '지역 상생 일자리 모델'을 만들고 일자리 창출, 식품산업 발전, 지역 농민 소득을 증가시키겠다고 밝혔다.
광양시는 8일 시청 접견실에서 한국팀 주장을 맡아 남자 축구 사상 첫 준우승의 위업을 달성하는데 크게 기여한 황태현 선수와 부모(황수환, 강수정)를 초청해 격려하는 자리를 가졌다.	광양시는 8일 오후 시청 접견실에서 2019 FIFA U-20 폴란드 월드컵에서 한국팀 주장 황태현선수와 부모를 초청해 방옥길 부시장을 비롯한 축구협회장 등과 격려하는 자리를 가졌다고 밝혔으며 앞으로도 더욱 큰 선수로 발전할 수 있도록 부모님뿐만 아니라 광양시, 시 체육회가 함께 노력할 것이라고 말했다.
대전시 자치구 공무원들이 근로자의 날(5월 1일)에 휴무키로 해 논란이 되는 가운데, 대전시는 노조의 압박에도 불구하고 휴무하지 않기로 한 것은 외부의 부정적 시선과 불편 민원 우선 측면에서 올바른 판단으로 보인다.	대전시 자치구 공무원들이 5월 1일 근로자의 날을 맞이해 지방공무원 복무조례를 근거로 휴무하기로 해 논란이며, 논란을 피하기 위해서는 시민들과 외부의 부정적인 시각과, 시민 공감을 우선적으로 해결 해야할 것이다.
경북도의회가 27일  2019년도 방위백서를 비롯한 역사를 부정하는 모든 왜곡·날조된 행위를 즉각 중단하고 즉각 폐기할 것을 요구했다. 	경북도의회는 독도에서 열린 제309회 경북도의회 제1차 정례회 본회의에서 일본 정부의 방위백서에서 독도가 일본 영토라는 주장을 즉각 폐기하라고 강력 규탄했으며 독도는 명백한 대한민국 고유 영토임을 확실히 재천명했다.
대구지역 모든 유치원이 유치원 입학관리시스템 '처음학교로' 등록을 마쳤으며, 대구시교육청에 따르면 2020학년도 대구시 유치원 유아모집·선발에 참여한 공립 113개, 사립 229개 총 342개 유치원이 모두 등록했다고 최근 밝혔다.	대구시 교육청에 따르면 유치원 입학 시 학부모가 온라인으로 유치원 입학 절차(접수·추첨·등록)를 완료할 수 있는 시스템인 처음학교로'에 대구시의 총 342개 유치원이 모두 등록을 끝냈으며, 1일부터 학부모는 ‘처음학교로’ 회원가입과 참여 유치원 현황 확인이 가능하다.
여수광양항만공사는 올해 초 수립한 '광양항 붉은불개미 방제 대책'에 따라 부두 내에 주기적인 약제 살포와 잠재서식 환경을 제거하는 등 붉은불개미 유입 차단에 적극 나서고 있다.	"최근 평택항과 부산항에서 붉은불개미가 발견되면서 항만공사는 '광양항 붉은불개미 방제 대책'을 수립하여 붉은불개미 유입 차단에 최선을 다하고 있다.
"
"상한 나라의 며느리'에서 최현상 이현승 부부는 출산 상담을 받기 위해 산부인과를 찾는 모습이 담겼으며 이날 최현상은 아내 이현승에게 ""무리하게 하고 싶지 않다""고 말하며 자연분만과 제왕절개에 대한 고민을 털어놨다."	24일 방송된 MBC '이상한 나라의 며느리'에서는 산부인과를 방문해 간접적으로 산통 체험을 경험하는 최현상 이현승 부부의 모습이 전파를 탔다.
이기우 인천재능대학교 총장이 9급 공무원으로 시작해 교육부 차관에 오르며 ‘고졸 신화’, ‘공무원 신화’, ‘100년에 한 번 나올까 말까 한 공무원’ 등의 수식어를 붙인 자서전 이기우의 행복한 도전 을 출간했다.	"이기우 인천재능대학교 총장이 9급 공무원에서 교육부 차관까지 오른 신화창조를 담은 ""이기우의 행복한 도전'을 출간했으며, 총 6개 장으로 구성해 용감한 도전이 삶을 이끌어 줄 것이라는 메시지를 전한다."
통일부가 3.1절 100주년 기념행사 및 타미플루 전달과 관련 대답이 늦어지는 것에 대해 “변동 사항이 없다”고 밝혔다.	북한에 타미플루 20만 명분과 신속진단키트 5만개 지원이 늦어지는 것에 대해 통일부는 북측의 입장을 기다리고 있다며 변동 사항이 없다고 밝혔다.
광주시체육회가 6일 오후 4시 빛고을체육관에서 개최한 ‘제100회 전국체육대회 광주시선수단 역대 최고 성적 달성 성과보고회’에서 이용섭 광주시장을 비롯한 내빈들이 광주를 빛낸 영광의 얼굴들과 내년 더 높은 목표를 향해 결의를 다졌다.	제100회 전국체육대회에서 종합10위를 차지하며 원정 체전 역대 최고 성적을 거둔 광주선수단 등은 이용섭 광주시장을 비롯한 광주시, 광주시의회, 광주시교육청 관계자들에게 입상한 것에 대해 축하받았다.
시민들이 애용하는 엄사도서관에 직원들이 장기간 공석이어서 이용 시민들에게 불편이 초래되고 있다.	평일 300여 명의 시민들이 찾아오는 엄사도서관의 사무실 직원 중 과반이상이 3월 3일부터 현재까지 40여 일 간 연가 또는 병가를 낸 상태여서 이용 시민들에게 불편을 끼치고 있다.
문재인 대통령은 '우리 사회 각계각층에서 정의로운 일을 한 의인'들과 함께 새해 첫날을 보냈으며 특히 올해 100세가 된 생존 애국지사 임우철 지사와 전화통화를 하면서 감사와 새해 인사를 전했다고 밝혔다.	청와대는 문재인 대통령이 새해 첫 일정으로 ‘2018년을 빛낸 의인’ 6명, 청와대 참모진과 함께 남산에서 신년맞이 해맞이 행사를 갖고 오후에는 여러 분야의 국민과 통화하며 감사와 새해 인사를 전했다고 말했다.
행정안전부가 주관한 ‘2019년 상반기 지방재정 신속집행 추진실적 평가’에서 과천시가 최우수 기관으로 선정되어 인센티브로 특별교부세 6천100만 원을 지원받는다.	행안부는 전국의 자치단체를 5개의 그룹으로 나눠 4개의 항목에 대해 평가를 하는 '2019 상반기 지방재정 신속집행 추진실적 평가'를 진행했고, 그 결과 과천시가 68.04%의 집행률을 달성하며 우수한 실적을 내 최우수기관으로 선정 되면서 인센티브로 특별교부세를 지원받게 됐다. 
인천국제공항공사는 공항 활주로·계류장 등에서 사용되는 항공사 디젤 조업차량의 전기차 전환을 추진하면서 ‘전기조업차 급속충전기’를 시범운영할 예정이다.	인천공항공사는 쾌적한 대기환경을 조성하고 글로벌 공항 경쟁의 조건을 충족하기위해 항공사 디젤 조업차량을 전기차로의 전환을 추진할 계획이다.
전남도는 18일 문화체육관광부와 한국관광공사가 추진하는 ‘한국형 웰니스관광지 지원 사업’에 보성 ‘전남권 환경성질환 예방관리센터’가 선정되어 웰니스 시설 추가 선정정을 계기로 전남이 힐링과 웰니스관광의 대표지역으로 자리매김 하도록 국내외에 널리 알려나갈 계획이라 밝혔다.	18일 전남도는 건강과 치유를 목적으로  즐기는 관광인 '한국형 웰니스 관광지 지원 사업'에  보성 ‘전남권 환경성질환 예방관리센터’가 선정됐다”라고 밝혔다.
여수 화태~백야를 잇는 4개 연도교 사업이 내년 본격적인 착공에 들어갈 예정이며, 이에 따라 여수시 남면 화태도, 화정면 백야도를 연결하는 새로운 신 성장 해양관광벨트가 구축될 것으로 기대되고 있다.	"총 사업비 5277억원 예산을 들여 건설하게 될 ‘일레븐 브릿지’ 사업은 여수∼고흥간 관광명소를 잇는 새로운 신 성장 해양관광벨트를 구축하여 국내·외 관광객들에게 큰 인기를 끌 것으로 기대되고 있다.

"
서대석 광주 서구청장은 민선 7기 4년 동안 빚어온 노사갈등을 해소하는 중심 역할을 한 자유게시판을 부활시키는 등 사람중심의 행정을 펼쳐온 성과도 인정받아 올해 4월 광주지역에서는 유일하게 커뮤니티케어 선도도시로 선정되었다.	서대석 광주 서구청장이 표현의 자유 침해’ 논란을 일으킨 구청 내부 전산망의 자유게시판을 부활시켜 직원들과 소통하며 가장 큰 성과로 주목받은 커뮤니티케어 선도도시(지역사회통합돌봄) 사업을 진행하여 시민이 주인인 진정한 지방 자치 실현을 위한 행보를 펼치고 있다.
가정의 달 5월을 맞아 한국 구석기의 중심, 공주 석장리에서 구석기 축제가 개최되며, 주무대에서 펼쳐지는 뮤지컬 공연과 포토타임은 관광객에게 풍성한 볼거리를 제공할 예정이다.	가정의 달 5월을 맞아 온 가족이 함께 구석기 문화를 즐길 수 있는 구석기 축제가 한국 구석기의 중심, 공주 석장리에서 '공주 석장리로 떠나는 구석기 여행'이라는 주제로 오는 3일부터 6일까지 나흘 간 펼쳐지며 대한민국 최초의 구석기 유적인 석장리 유적을 테마로한 다양한 프로그램으로 색다른 체험과 재미를 제공할 예정이다.
도의회 민주당이 내년에도 시행할 예정인 '반값 교통비 지원사업'의 일환으로 경기도와 도의회가 청소년들의 버스요금 할인율을 높여 청소년이 사용한 교통비를 일부 환급하는 방안으로 접점을 찾아가고 있다.	경기도와 도의회가 청소년들의 버스 요금의 할인율을 50%로 확대하는 경우, 어린이 요금을 역전하는 문제점이 있어, 청소년들이 사용한 교통비를 환급해주는 방식으로 '청소년 반값 교통비' 정책을 실현하고자 한다.
부천시 여성창업 수공예 작가들이 부천시 여성창업 인큐베이팅 사업을 지원 받고 있는 곳으로 도예, 생활한복, 은 공예, 퀼트 등 다양한 영역에 있는 지역 예술 활동가나 수업 이수자들이 모여 활동하고 있는 예비창업 실습 공간 '여나래'가 주인공으로 수공예 작가들은 자신들이 만든 작품을 판매해 수익금 일부를 부천희망재단에 전달했다.	부천시 여성창업 인큐베이팅 사업을 지원받아 지역 예술 활동가나 수업 이수자들이 모여 활동하고 있는 예비창업 실습 공간 ‘여나래’가 자신들의 작품을 판매한 수익금 일부를 부천희망재단에 전달하며 위기에 처한 여성들을 돕는 일에 앞장서 화제가 되고 있다.
구례군이 기존 압롤트럭식 청소차량을 압축식 진개차로 교체하여 청소차량 4면에 지리산 풍경과 관광자원을 담아 산뜻하게 단장하고 미화원의 작업환경을 개선해 눈길을 끌고 있다.	아름다운 지리산정원과 지초봉 정상부근에 설치되고 있는 짚라인과 모노레일 등 레포츠 랜드를 홍보하기 위해 구례군은 광의면 청소차를 교체하면서 청소차량 4면에 야생화 테마랜드, 숲속 수목가옥, 짚라인, 모노레일 등의 풍경화를 담았다.
더불어민주당 서삼석 의원은 23일 당 원내대책회의에서 일본의 경제보복조치가 국내 농수축산분야로 확대될 가능성에도 적극 대비해야 한다고 주장했다.	더불어민주당 서삼석 의원은 국내 농수축산업의 일본 의존도를 극복하기 위해 시나리오별 매뉴얼이 조속히 마련되어야 한다고 주장했다.
질병관리본부는 오염된 어패류를 먹거나 상처 난 피부가 오염된 바닷물에 접촉할 때 감염되는 비브리오패혈증 환자가 6월 1명에서 7월 2명, 8월 15명으로 증가하고 있어 어패류를 충분히 익혀 먹는 등 각별한 주의가 필요하다고 30일 당부했다.	질병관리본부는 오염된 어패류를 생으로 먹거나 오염된 바닷물에 접촉할 때 감염되는 질환인 비브리오패혈증 환자가 매년 8∼9월에 집중적으로 발생하는 것을 확인하면서 어패류를 85℃ 이상 가열 처리해 먹는 등 각별한 주의가 필요하다고 30일 당부했다.
국토교통부는 19일 지방 중소도시와 읍·면지역을 위주로 올해 약 1천 가구의 장기공공임대주택을 공급한다고 밝혔으며 주변지역 정비계획 수립을 생략할 수 있도록 해 주변지역 정비계획 수립이 가능해졌다고 밝혔다.	국토교통부는 마을정비형 공공주택사업을 통해 올해 약 1천 가구의 장기공공임대주택을 공급할 예정이며, 국토부는 각 지자체가 제출한 제안서를 바탕으로 평가를 진행해 11월에 사업 대상지를 선정한다. 
오늘(30 8시 10분 방송되는 tvN ‘수미네 반찬’ 35회 ‘설 특집’에서는  지난 추석특집에 공개되어 화제를 모은 갈비찜의 업그레이드 버전인 얇은 LA갈비를 사용해 시간 절약과 저렴한 가격으로 맛볼 수 있는 LA갈비찜을 선보인다.	"오늘(30일, 수) 저녁 8시 10분 방송되는 tvN ‘수미네 반찬’(연출 문태주) 35회 ‘설 특집’에서는 LA갈비찜과 5가지 나물 반찬 레시피를 선보인다.
"
"나경원 원내대표가 ""선거에 관한 모든 업무를 보는 자리에 대선 캠프 출신 인사를 앉히겠다는 것은 앞으로 선거를 공정하게 하지 않고 부정선거도 획책할 수 있다는 메시지를 주는 것""이라며, 2월 임시국회를 거부하기로 했다고 밝혔다."	24일 문재인대통령의 조해주 중앙선거관리위원회 위원 임명 강행에 자유한국당과 바른미래당은 임명 강행시 조 후보자를 위계에 의한 공무집행 방해 혐의로 검찰 고발하겠다고 강력히 반발했고 특히 한국당은 2월 임시국회를 거부하기로 했다.
SBS 새 금토드라마인 동학농민혁명의 소용돌이 속에서 농민군과 토벌대로 갈라져 싸워야 했던 이복형제의 파란만장한 휴먼스토리를 그린 동학농민혁명을 본격적으로 그린 민중역사극 ‘녹두꽃’이 26일 밤 10시 SBS에서 첫 방송된다.	SBS 새 금토드라마 '녹두꽃'은 동학농민혁명의 소용돌이 속에서 민초들의 우렁찬 사자후를 담은 휴먼스토리를 그리며 이전의 사극과 전혀 다른 패러다임을 제시한다.
전남도는 '가고 싶은 섬' 가꾸기 사업 대상지로 선정된 14개 섬 주민들을 대상으로 오는 22일 오후 2시 전남도 섬발전지원센터에서 섬 여행코스와 테마를 디자인하고 이에 따른 해설 시나리오를 만들기 때문에 주민의 생각으로 만드는 '섬 콘텐츠'를 갖추기 위한 '섬 코디네이터 양성교육'을 진행한다.	전러남도가 19일 ‘가고 싶은 섬’ 가꾸기 사업 대상지로 선정한 14개 섬 주민들을 대상으로 12월까지 섬 코디네이터 양성교육을 진행할 예정이다.
용인시는 지난 4~5월 공모를 통해 시 문화 창달에 앞장서 온 시민을 접수받고, 23일 분야별 전문가 16명으로 구성된 심사위원회를 열어 최종 수상자를 선정했으며 다음 달 27일 예정된 제24회 용인시민의 날 기념식에서 수상자에게 상패를 수여할 예정이다.	26일 용인시는 공모를 통해 시 문화 창달에 앞장서 온 시민을 접수받고 분야별 전문가로 구성된 심사위원회를 열어 문화, 예술, 지역사회봉사 부문 등 3명을 문화상 수상자로 선정했다고 알렸다.
광양상공회의소는 지난 7일 전남도에 여수·순천상공회의소와 공동으로 광양만권 지역경제 및 국가경제에 심각한 악영향을 줄 수 있는 포스코 광양제철소 고로(용광로) 조업정지 처분을 재고해 줄 것을 요청하였고 이에 대해 전남도는 조업정지 처분을 재고해 줄 것을 간곡히 요청하였다.	광양·여수·순천상공회의소는 환경부와 전남도가 지적한 안전밸브(브리더) 개방에 대해 다른 국가에서는 일반 정비절차로 인정하고 법적 규제를 하지 않는 필수 공정과정이라는 점을 강조하며 광양을 비롯한 국가 전체 경제에 미치는 영향을 고려해 조업정지 10일 처분을 재고해 줄 것을 요청했다
대청호변의 깨끗한 자연환경과 오염되지 않아 친 환경농업의 최적지로 꼽히는 옥천 군북면 증약리에서 민경권(65) 김혜진 부부는 요즘 유기농법으로 기른 신선한 쌈 채소수확이 한창이다.	대청호 상류에 자리잡아 맑고 청정한 자연환경때문에  친환경 쌈 채소하우스가 밀집된 옥천 군북면에서 친환경 쌈채소 수확이 한창이다.
28일 방송된 KBS '시사기획 창'에서 최상주 KHM아경그룹 회장의 논란에 대해 파헤친 가운데 최상주 회장이 방송 몇 시간 전에 사임의사를 밝혔다고 밝혀 이목이 집중되고 있다.	최상주 KHM아경그룹 회장은 28일 본인의 주식거래 의혹을 다룬 KBS '시사기획 창' 방송 몇 시간 전 사임의사를 밝혔다.
19일 본회의를 열어 5.18 민주화운동 피해자나 친족 등이 진상규명조사위원회에 진상규명을 신청할 수 있는 기한을 늘리는 ‘5·18 민주화운동 진상규명을 위한 특별법’ 개정안을 의결하여 진상규명조사위가 연내 출범할 것이라는 전망이 나온다.	국회는 19일 본회의를 열어 5·18 민주화운동 피해자나 친족 등이 진상규명조사위원회에 진상규명을 신청할 수 있는 기한을 늘리는 내용의 ‘5·18 민주화운동 진상규명을 위한 특별법’ 개정안을 의결했다
경기도시공사는 주거복지 사각지대에 있는 아동ㆍ청소년 빈곤가구의 생활편의를 위해 공공임대주택을 우선적으로 제공하는 아동 주거권 확대방안을 추진한다고 밝혔다.	경기도시공사는 도내 최저 주거기준에 미달하는 주거환경에서 만 18세 미만의 아동·청소년과 함께 생활하는 무주택가구를 대상으로 공공임대주택을 우선 제공하는 방안을 추진하며, 대상자는 해당 주민센터에 입주 신청을 하고 심사를 거쳐 신청자와 계약을 체결하면 된다.
SK그룹은 16일 베트남 1위 민영기업인 빈그룹(Vingroup)과의 전략적 파트너십 체결을 통해 동남아 시장을 확대해 나가는 한편, 향후 빈그룹 지주회사 지분 약 6.1%를 10억 달러(한화 약 1조1800억 원)에 매입하는 계약을 체결했다고 전했다.	"SK그룹이 16일 베트남 하노이에서 빈그룹 지주회사 지분 약 6.1%를 10억 달러에 매입하였는데, 이는 베트남 1위 민영기업인 빈그룹과의 전략적 파트너십 체결을 통해 향후 베트남 시장에서 신규사업 투자는 물론 국영기업 민영화 참여와 전략적 인수합병(M&A) 등을 적극 추진하고 동남아 시장을 확대해 나가겠다는 계획이다.
"
K리그2 선두를 달리고 있는 광주FC가 오는 20일 오후 7시 30분 광주월드컵경기장에서 서울이랜드FC와 하나원큐 2019 K리그2 12라운드 홈경기를 치른다.	지난 3월부터 하나원큐 2019 K리그2 선두를 차지한 광주FC는 오늘 오후 7시 30분 광주월드컵경기장에서 서울이랜드FC와  12라운드 홈경기를 가져 12경기 무패행진에 도전한다. 
여수시 이순신광장 거북선 조형물에서 발생한 추락사고의 원인 조사를 위해 경찰은 당분간 현장을 통제하고 수사에 들어갈 예정이다. 	여수경찰서는 현장을 통제하고 부서진 나뭇조각을 수거해 정밀 감식을 벌이는 등 이순신광장 거북선 추락사고 원인 조사에 착수했고, 여수시에 대해서는 사후 관리 부분을 집중적으로 조사할 방침이다.
동국대학교의 학점은행제 교육기관인 동국대학교 전산원이 영화학전공 포함 10개 전공 18개 트랙에서 2020년도 신입생을 100% 면접 전형으로 모집한다.	"학점은행제 동국대학교 전산원이 주간과 주말 학사과정의 신입생을 영화학전공 포함 10개 전공에서 2020년도 신입생을 100% 면접 전형으로 모집하며 동국대 전산원 홈페이지, 유웨이어플라이 및 진학어플라이 홈페이지를 통해 지원할 수 있다.
"
자유한국당은 차기 지도부를 뽑는 2·27 전당대회 날짜가 제2차 북미 정상회담 일시와 겹쳐 있어 전당대회 날짜 변경을 검토했으나 당 사무처에 7일 회의를 열어 날짜를 당기거나 미루는 것을 실무적으로 논의해보라고 지시했다.	" 자유한국당은 차기 지도부를 뽑는 2·27 전당대회 날짜가 제2차 북미 정상회담 일정(27-28일)과 겹치자 당 선거관리위원장을 맡은 박관용 전 국회의장은 ""전당대회가 북미회담에 밀리면 의미가 없어진다""면서 날짜를 변경할 것을 논의해보라고 지시하고 당내에서는 이른바 ‘컨벤션 효과’를 거두기 위해 일정을 변경해야 한다는 의견이 제기되어 전당대회 날짜 변경을 검토키로 했다."
행정안전부가 국가관·사명감·공직관이 투철하고 국정과제 추진 및 국가 경쟁력 강화에 기여한 공무원에게 녹조근정훈장을 수여하는 가운데, 충북도 도로과 권선욱 과장은 충북대 토목공학과에서 토목 건설 분야 박사 학위, 국가공인 토목시공기술사 자격증을 취득하여 충북대 토목공학과에서 토목 건설 분야 박사 학위를 취득하였다.	지난 1일, 충북도의 최대 현안사업이었던 서청주IC-증평IC 구간 설계비 확보와 전 구간 확장 사업에 공로를 세운 권선욱 도로과장이 국정과제 추진 및 국가 경쟁력 강화에 기여한 공무원에게 수여되는 공직 최고의 상인 녹조근정훈장을 수상했다.  
이달 단행되는 개각의 폭이 예상보다 축소될 전망이다.	이달 예정된 개각의 폭이 후임자 검증 문제와 일본의 경제보복 사태로 예상보다 축소되고 개각 시기도 지연될 것으로 보인다.
다음달 4일까지 대구백화점에서 '맛있는 여름의 시작 여름 특별가 대전'을, 대구백화점은 본점 지하 1층 영풍문고에서 6월 매주 토요일(1, 8, 15, 22, 29일) 스페셜 프로모션을 진행하며 30일부터 다음달 6일까지 대구백화점에서 '맛있는 여름의 시작 여름 특별가 대전'을 진행한다.	대구백화점은 스페셜프로모션을 진행하며 선착순 30명에게 캐릭터 노트를 증정하며 이벤트홀에서는 골프웨어 ‘루이까스텔’을 최대 70% 할인가격에 만날수 있다. 
아산시가 민간사업자 모집공고를 내고 같은달 17일 참여희망자를 대상으로 사업 설명회를 개최하여 관광진흥법 따른 관광단지, 국토의 계획 및 이용에 관한 법률 따른 관광휴양형 지구단위계획, 도시개발법에 따른 도시개발사업 등을 통해 개발사업을 시행할 예정이다.	아산시가 수도권에서 1시간 이내 접근이 용이한 쌀조개섬의 관광지 개발에 시동을 걸었지만 시너지 효과도 기대되는 반면에 민간투자가 쉽게 이루어 질 수 있겠느냐는 우려도 동반되고 있다.
CJ제일제당이 출시 6개월 만에 130만 개를 판매한 비비고 불닭갈비 볶음면과 '고메 중화짜장'을 출시하며 면 시장 외연 확대에 본격적으로 나서고 있다.	CJ제일제당이 HMR(가정간편식) 출시 6개월 만에 130만 개를 판매한 자신감을 바탕으로 신제품 ‘비비고 불닭갈비 볶음면’과 ‘고메 중화짜장’을 출시하며 제품군 확대에 본격적으로 나서 전체 시장의 변화와 성장을 주도하고 있다.
괴산군은 22일 군청 회의실에서 이차영 군수를 비롯 각 부서장 및 담당 공무원 50여 명이 참석한 가운데 생활형 SOC사업 및 2020년도 정부예산 확보 대상사업 보고회를 개최하여 생활밀착형 SOC사업 및 내년도 정부예산 발굴 대상사업 등 총 71개 주요사업(3157억 원)에 대한 국비확보 전략을 논의하였다.	생활밀착형 SOC사업 및 내년도 정부 예산 발굴 대상사업 등 총 71개 주요사업에 대한 국비확보 전략을 논의하기 위해 괴산군이 군청 회의실에서 2020년도 정부예산 확보 대상 사업 보고회를 개최 하였으며 군은 여러 부처와의 협조체계를 구축해 다양한 예산 확보 활동에 나서겠다는 의지를 보였다.
30일 부산시와 경남도는 조류인플루엔자(AI) 항원이 검출된 을숙도와 사천만 반경 10km를 ‘야생조수류 예찰 지역’으로 설정하고 예찰 활동을 실시했으며, 부산시와 경남도는 설 연휴를 앞두고 긴장을 늦추지 못하고 있다.	안성시 금광면에서 구제역 확진 농가가 발생해 이동 제한 조치가 내려진데 이어, 을숙도와 사천만에서 저병원성으로 판정된 조류인플루엔자(AI)가 검출되어 방역 당국이 긴장하고 있다.
지난 17일 개봉한 독립영화 '메이트'는 돈도, 마음의 여유도 없는 2030세대의 현실을 자세하지만 억지스럽지 않게 그려냈다.	지난 17일 개봉한 '메이트'는 청춘들이 연애관, 인생관 등에 공감할 수 있는 ‘N포세대’의 현실 로맨스를  담은 영화이다.
인천시가 장기미집행 공원일몰제 대응 방안으로 2022년까지 지역 46곳에 291만m2의 공원을 조성하겠다고 밝혔으나 재정 건전성 우려로 민간특례사업과 임차공원사업이 있지만 이마저도 쉽지 않아 고민은 깊어지고 있다.	인천시는 공원일몰제 대응 방안으로 2022년까지 지역 46곳에 공원을 조성하지만, 예산 부족으로 인해 지방채 발행이 불가피한 상황이다. 
"이국종 아주대학교 의과대학 교수는 이재명 경기지사의 항소심 당선무효형 판결과 관련, 대법원에 10쪽 분량의 자필 탄원서를 제출하며 ""선진국형 중중외상환자 치료체계 도입을 위해 최선을 다하고 있는 현직 도지사에 대해 대법관분들이 베풀어 주실 수 있는 마지막 관용인 동시에 여러 중증외상환자를 위한 선처를 호소하는 탄원서를 대법원에 제출했다""고 밝혔다."	아주대학교 의과대학 이국종 교수는 이재명 경기지사의 항소심 당선무효형 판결과 관련해 경기도민의 생명과 안전과도 밀접한 연관이 있음을 알아달라며 선처를 호소하는 탄원서를 19일 대법원에 제출했다.
충주시는 정부의 생활밀착형 SOC 추진계획에 발맞춰 올해 본예산보다 1757억원(18.8%)이 증액된 1조1096억원 규모의 2019년도 제1회 추가경정예산안을 편성해 9일 충주시의회에 제출했다.	충주시는 경기침체, 고용감소 우려 등이 만연한 경제에 활력을 불어넣기 위해 올해 본예산 9339억원보다 1757억원이 증액된 1조 1096억원 규모의 역대 최대 추경예산을 편성했다.
음성군은 투명한 아파트 관리와 주민자치의 토대를 마련하고자 동별 대표자 선거 등 관리업무와 관련된 투표 시 발생할 수 있는 문제점을 사전에 차단하고 관리업무의 투명성을 높일 수 있는 '공동주택 온라인' 투표 비용 전액을 지원한다고 밝혔다.	음성군은 20일 의무적 관리대상 공동주택 단지를 대상으로 PC와 이동통신 단말기를 사용해 투표 참여 기회를 확대하고 시간, 비용을 줄이며 관리업무의 투명성을 높일 수 있는 '공동주택 온라인' 투표 비용 전액을 지원할 예정이라고 알렸다.
2019 광주 세계마스터즈수영선수권대회를 앞두고 1일부터 선수들이 속속 입촌하는 등 대회 분위기가 달아오르며 참가자 총 5672명 가운데 2000여명은 선수촌에 머물고 있고 아티스틱·수구 동호인들은 경기가 열리는 염주종합체육관과 남부대 수구경기장에서 오는 3일부터 훈련을 시작한다.	오는 5일  개막하는 지구촌 수영 동호인들의 대축제,  2019 광주 세계마스터즈수영선수권대회가 아티스틱 수영과 수구를 시작으로 14일간 광주와 여수 일원에서 펼쳐 진다.  
17일 진도군수협 서망사업소에 따르면 진도군 조도 인근과 신안 만재도·가거도 해역에 ‘물 반 오징어 반’ 황금어장이 형성되면서 서망항에 오징어잡이 어선, 상인, 관광객들이 몰려 들썩이고 있다.	요즘 서해에서는 오징어가 풍어를 이루고 있고 신선도가 탁월한 진도 해역 오징어를 사기 위한 각 지의 수산물 도매상과 관광객들로 문전성시를 이루고 있다.
광주 북구는 주민등록 민원업무 처리 시 법규해석 차이에 따른 업무처리를 일원화하고 실제로 발생하는 다양한 민원사례를 연구해 민원행정의 신뢰성을 높이기 위해 '주민등록 학습동아리'를 활발히 운영하고 있다.	"광주 북구가 주민등록 민원업무 처리 시 법규해석 차이에 따른 업무처리를 일원화하고 실제로 발생하는 다양한 민원사례를 연구해 민원담당 공무원의 실무능력 강화 및 주민불편을 최소화하기 위해 마련한 ‘주민등록 학습동아리’ 활동을 활발히 전개하고 있다.
"
스승의 날을 앞두고 교권침해 학생과 학부모에 대한 징계와 처벌을 강화하는 교권 보호망 구축이 시급하다.	스승의 날을 앞두고 교사 10명중 6명 이상이 교권이 하락한 것으로 여긴다는 조사 결과가 공개되었으며, 교권 추락에 지쳐 교단을 떠나는 교원이 늘어나는 현실을 가볍게 여기지 말고 학교 교육 정상화의 첫 번째 과제로 교권을 지키기 위한 대책 마련이 절실한 실정이다.
화성시문화재단 동탄복합문화센터가 국내 공공체육시설 최초로 대한심폐소생협회 일반인 심폐소생술 교육기관 승인을 획득해 화성시민들에게 상시적으로 심폐소생술 교육을 제공할 예정이다.	"화성시문화재단 동탄복합문화센터가 국내 공공체육시설 최초로 심폐소생술 및 심장충격기 사용법을 교육할 수 있는 기관인 대한심폐소생협회 일반인 심폐소생술 교육기관(Training Site) 승인을 획득하여 화성시민들의 생활안전 역량 강화에 큰 역할을 할 것으로 전망되고 있다.
"
2차 북미 정상회담을 앞두고 금강산 관광과 개성공단 가동 등 남북 경협사업이 북한의 과감한 비핵화를 끌어낼 지렛대로 급부상할 것으로 보인다.	2차 북미 정상회담을 앞두고 전날 밤 10시부터 35분간 문재인 대통령이 미국 트럼프 대통령과의 통화에서 북한의 비핵화에 상응하는 조치로 제재 완화 시 남북경협을 통해 부담을 나누겠다는 뜻을 전하자 트럼프 대통령도 긍정적인 반응이었지만 회담에서 구체적으로 적시될지는 지켜봐야 한다.
이번 주 국회는 추가경정예산(추경)안 처리를 두고 여당과 야당이 팽팽히 맞서 임시국회 회기 마지막 날인 19일 추경안 처리가 이뤄질지 관심을 끌고 있다.	이번 주 국회는 추가경정예산(추경)안 처리를 두고 추경안 원안 사수를 고수 중인 여당과 대대적 삭감 방침을 밝힌 야당이 팽팽히 맞서 임시국회 회기 마지막 날인 19일 추경안 처리에 대해 여야 간 격돌이 예상되며, 아직도 여야 간 추경안 처리를 위한 본회의 일정에 합의하지 못했다.
음성군건강가족 다문화가족지원센터는 지난 2일 다문화 여성을 대상으로 면접을 거쳐 10명의 수강생을 선발해 오는 23일 첫 수업을 하는 '음성 다문화 엄마학교'를 운영한다.	음성군이 운영하는 '음성 다문화 엄마학교'는 지난 2일 충북도에 처음으로 거주하는 다문화 여성을 대상으로 면접을 거쳐 10명의 수강생을 선발하여 지난 9일 입학식까지 마쳤으며 오는 23일부터는 기본적인 초등교과 내용에 관한 첫 수업 시작한다. 
공주시는 '세계유산 관광도시, 신바람 공주' 조성을 위해 3월부터 11월까지 미르섬, 석장리 계절별 꽃 단지, 정안천생태공원에 상록화초를 식재해 다양한 계절 꽃으로 시민 및 관광객들의 다시 오고 싶은 마음을 이끌어낼 계획이다.	공주시는 3월부터 11월까지 올해 주요 사업으로 '세계유산 관광도시, 신바람 공주' 조성을 위한 2019년 국토공원화사업을 본격적으로 추진함과 동시에 오는 9월 제65회 백제문화제를 개최하여 활기찬 거리를 만들 예정이다.
지역 유통업계가 오프라인 시장의 활로를 '명품'에서 찾고 있는 가운데 2030세대를 겨냥해 럭셔리 워치&쥬얼리 페어'를 열어 세계 최정상급 시계 및 주얼리를 판매한다.	명품의 경우 모조품이 많아 오프라인 구매 행동 경향이 크기에 롯데백화점은 2030을 겨냥하여 명품시계 및 보석을 할인 판매행사를 진행한다. 
보령시는 오는 10일까지 다문화 가족 구성원 중 블로그와 소셜미디어 활동으로 보령의 멋과 맛을 지구촌에 알리기 위해 나라별 2-3명씩 최대 16명을 모집할 계획이며 신청자격은 만 19세 이상의 성인으로 공고일인 25일 현재 대한민국 국적을 취득한자로 보령시에 주민등록이 되어있어야 하고 한국어 소통이 가능해야 한다.	보령시는 오늘 10일까지 보령에 거주하는 다국가 출신을 활용해 해외에 보령을 홍보하기 위해 다문화 관광 기자단을 나라별 2~3명씩 최대 16명 모집하며, 기자단은 보령의 대표 관광지와 먹거리를 체험하고 느낀 바를 기사로 작성해 SNS에 게재하는 방식으로 홍보활동을 해야 한다.
전남도는 13일 ‘전남도 소비자정책위원회’ 심의 의결에 따라 택시 운임·요율 조정안 심의를 거쳐 기본요금 현행 2천800원에서 3천300으로 15.4% 인상 기준을 마련했다고 밝혔다.	전남도는 ‘전남도 소비자정책위원회’ 심의 의결에 따라 광주 외에다른 시·도 평균 인상률을 반영해 인상률을 15.4%로 인상 조정해 택시 요금을 15.4% 인상 기준을 마련했다고 밝혔다.
광명시는 28일 시청 대회의실에서 학교 밖 교육 운영 방향과 발전 방안을 모색하기 위한 '광명의 아이들, 행복한 교육을 위해 마을교육공동체는 어떻게 준비해야 하나?’라는 주제로 광명 마을교육공동체 포럼을 개최했다.	광명시는 지난 28일 시청 대회의실에서 학교 밖 교육의 운영 방향과 발전 방안의 탐색을 위해 박승원 시장, 교사와 학부모, 마을활동가 등 100여 명이 참가한 가운데 광명 마을교육공동체 포럼을 실시했다.
노태우 전 대통령의 아들 재헌씨가 지난 23일 오전 11시께 광주 북구 운정동 국립 5·18민주묘지를 찾아 오월 영령에게 사죄했다.	노태우 전 대통령의 아들 재헌(54)씨가 ‘5·18 피고인’으로 처벌받은 전두환·노태우 전 대통령의 직계가족 중 처음으로 국립5·18민주묘지를 찾아 윤상원 열사 묘소 앞에서 무릎 꿇고 참배하는 등 오월 영령들에 사죄했다.
구인구직 매칭 플랫폼 사람인(www.saramin.co.kr)이 구직자 480명을 대상으로 '입사지원 후 불합격 통보 여부'에 대해서 조사한 결과 구직자들이 불합격 여부를 알 수 없어서라는 결과를 발표했다.	‘정보불균형’ 문제의 발생으로 구직자 10명 중 9명(94%)이 ‘불합격자에게 기업이 해당 사실을 통보해야 한다’고 생각했고 그 중 다수가 그 사유 또한 고지해야한다고 밝혔다.
4일 전국적으로된 6월 모의고사는 국어, 영어, 한국사, 사회탐구 등의 영역이 전 영역에 출제되나, 6월 모의고사 등급컷은 일부 한정되어 있으며 관련기관에서는 6월 모의고사 등급컷을 공개할 예정이다. 	4일 실시되는 6월 모의고사는 전국의 고 3학생들과 서울시를 제외한 전국의 고 1,2학생들이 대상이며 시간표는 실제 수능 시험과 동일하고 고 3의 경우 대부분의 영역에서 전 범위가 출제된다.  
김옥련발레단은 오는 21일 오후 2시 을숙도문화회관 대공연장에서 극단 세아미와 함께 창작춤공연 '꽃비'를 선보인다.	세월호 참사 희생자를 위로하고 남은 사람들의 슬픔을 달래줄 김옥련 발레단의 '꽃비'가 21일 오후 2시 을숙도문화회관 대공연장에서 초연하여, 당시의 참혹함과 무력함을 표현한다.
2일 농업기술센터는 서구화된 식습관과 다양한 먹거리로 인해 매년 쌀 소비가 감소하고 있어 쌀로 만든 떡, 쿠키 등 전통한식을 재해석한 음식전시와 시식을 통해 우리 쌀 소비를 촉진시키고자 '다양한 우리 쌀 활용, 한식디저트 교육'에 대한 성과보고회를 가졌다.	옥천농업기술센터는 2일 농산물 가공교육장에서 쌀로만든 떡, 쿠키 등 전통 한식을 재해석해 쌀 소비의 촉진하고, 홍보를 위해 우리 쌀을 활용한 한식 디저트 교육에 대한 성과 보고회를 가졌다.
대구소방안전본부는 대구 전역 소방차 진입 곤란 및 주택밀집지역 47곳에 소화기 500대를 설치하여 화재 발생 시 누구나 소화기로 초기 진화를 할 수 있도록 지원하고 있다.	시민들의 자발적인 소화 활동 참여를 유도하고 동네 화재 지킴이 역할을 톡톡히 하고 있는 대구소방안전본부의 ‘골목길 안심 소화기’를  올해 말까지 화재 취약 골목 9곳에 추가 설치한다.
인천시 서구가 오는 23일 대회의실에서 '언어천재 조승연' 작가를 초청해 '서구아카데미'를 개최하며 외국인과 한국인을 대상으로 두 개의 유튜브 채널을 개설해 글로벌 감각이 뛰어난 조승연 작가의 강연을 통해 글로벌 융합시대가 원하는 인재상에 대해 알아보는 시간을 가질 계획이다.	인천시 서구는 오는 23일 대회의실에서 '조승연의 이야기 인문학', '플루언트' 등 다수의 도서를 출간한 스타작가인 조승연작가를 초청해 '자녀를 융합적이고 글로벌한 인재로 키우는 법'이라는 주제로 '서구아카데미'를 개최한다.
경남도는 지역의 웹툰 창작자 양성과 만화문화 향유를 위한 '웹툰캠퍼스 조성 및 운영 사업'에 선정되어 국비 4억 원, 도비 2억 원, 시비 2억 원을 투입하여 창원시 의창구 대원동 한국산업단지 동남전시장 서관 체육관 3층에서 250평 규모로 리모델링해 창작자 입주공간, 기업입주실, 교육공간, 회의실, 전시·체험관 등을 갖춘 웹툰 융·복합 문화거점으로 조성할 계획이다.	27일 경남도는 창원시 의창구 대원동 한국산업단지 동남전시장 서관 체육관 3층을 리모델링 해 지역의 웹툰 창작자 양성과 만화문화 향유를 위한 거점을 마련하여 12월 개소한다고 밝혔다.
충남 서산 대산공단에서 유증기에 이어 암모니아 유출 사고로 1200여 명의 환자가 발생한 것으로 알려지면서 재난 수준의 대책이 요구되고 있다.	"충남 서산 대산공단에서 유증기에 이어 암모니아 유출 사고까지 터져 인근 주민들이 공포에 시달리며 사고를 두고 기업과 관계기관의 안일한 대처를 비난하는 목소리가 커지고, 또한 잦은 사고가 대형사고 전조증상일 수 있다는 분석이 나와 철저히 대비해야 하겠다.
"
정해영 성주경찰서 청문감사계장 경위 경찰에서는 2015년 '피해자 원년의 해'로 선언하면서 일선 경찰서마다 피해자 전담 경찰관이 범죄 피해를 입은 피해자에게 경제적·심리적 지원을 하는 역할을 하고 있다.	현재 전국 경찰서에서 시행중인 범죄 피해자 지원제도는 전문기관을 통한 '심리적 지원', 지자체와 연계한 '경제적 지원' 뿐만 아니라 2차 피해를 예방하기 위한 신변보호용 스마트워치 지급, 임시숙소 제공 등 신변보호와 함께 대한법률구조공단의 법률적 지원도 있으니 이를 알지 못해 피해를 보는 피해자가 더 이상 나오지 않도록 세심한 관심이 필요하다.
제주도에서말칼국수가 1년 여 만에 입소문을 타고 있으며 시원한 국물맛과 48시간 숙성한 반죽으로 만든 쫄깃한 면발이 어우러져 남녀노소 모두에게 사랑받고 있다.	제주도가 고향인 김주연·김봄이나 자매가 운영하고 제주 해녀들이 직접 채취한 해산물을 공수받아 음식을 만드는 제주보말칼국수가 개점 1년만에 맛집으로 자리매김하고 있다.
인천항운노동조합과 공사업체 간 처음 있는 분쟁으로 옹진군 백령도 용기포항과 대청도 선진포항 물양장 정비공사에 투입된 레미콘 차량에 대해 인천중부경찰서에 고소장을 접수시켰다.	백령도와 대청도에 있는 용기포항 확장 공사와 군부대 공사 등이 예정되어 있지만 하역비를 놓고 인천항운노동조합과 공사업체가 분쟁하고 있다.
인천국제공항공사는 31일부터 2일간 열리는 ‘인천공항 스카이 페스티벌’에서 ‘항공과 공항산업’을 주제로 열리는 문화와 정보 교류의 장인 SKY EXPO, 4차 산업혁명 혁신기술을 보유한 중소기업과 사회적 기업, 인천공항 내 상주기관 등 총 29개 기업이 참가할 예정이며 행사장 야외광장에서는 경력단절 여성의 꿈과 재능을 돕는 플리마켓 ‘마켓엄마꿈틀’과 인천시소상공인협회와 함께 하는 ‘푸드존’이 열린다.	인천국제공항공사는 31일부터 2일간 사회가치 프로그램인 인천공항 스카이 페스티벌을 열고 이 행사를 통해 경력 단절 여성이 참여하는 플리마켓, 지역 소상공인이 참여하는 푸드존 등과 함께 항공과 공항산업을 주제로 문화와 정보교류의 장인 SKY EXPO도 선보일 예정이다. 
과학기술정보통신부와 한국과학기술기획평가원이 주관한 ‘2018년도 연구개발지원단 사업수행 실적 및 차년도 사업계획’ 평가에서 대구TP 과학기술진흥센터는 전국 17개 시·도에서 운영되고 있는 지역별 R&D 기획·관리 전담기관으로 선정되었다.	"대구TP가 전국 17개 시,도에서 운영하고 있는  ‘2018년도 연구개발지원단 사업수행 실적 및 차년도 사업계획’ 평가에서 전국 최우수에 해당하는 ‘우수등급’에 선정되면서 3년 연속 최우수 등급을 받아 지역 기업의 R&D 역량개발에 한층 더 탄력을 받을 예정이다.
"
영산강 죽산보 해체 여부를 두고 지역민과 지자체, 시의회, 환경단체 등이 제각각 목소리를 내는 등 갈등이 재점화되는 가운데, 나주시의회는 최근 제216회 5차 본회의에서 ‘영산강 죽산보 해체 반대 건의안’을 채택했고, 환경단체는 보 해체 후 취수 시설에 대한 대책을 마련한다고 밝혔다.	3일 나주시의회는 의원 15명중 13명이 공동발의한 ‘영산강 죽산보 해체 반대 건의안’을 채택했고, 환경단체는 이에 대해 반발하고 있다.
2014년부터 이어오고 있는 '감성캠퍼스 조성 프로젝트'는 학업에 지친 학우들에게 소통의 장을 만들어 대학생활의 낭만을 찾아주는 한편, 서로 소통하며 활력 넘치는 캠퍼스를 만들기 위해 총학생회와 대의원회가 힘을 합쳐 1년 동안 추진하는 프로젝트이다.	대구과학대학은 학업에 지친 학우들에게 상호 교류의 장을 만들어 대학생활의 낭만을 찾아주고 소통하며 활력 넘치는 캠퍼스를 만들기 위해 '감성캠퍼스 조성 프로젝트'를 실시하며 1개의 주제를 설정해 캠퍼스의 즐거움과 새로운 경험을 할 수 있도록 14개 주제로 12월까지 진행된다.
영화 ‘튼튼이의 모험’은 빽도 재능도 없지만 레슬링에 대한 사랑만큼은 국가대표 급인 튼튼한 18세 소년 충길의 이야기를 그린 영화다.	아무것도 가진 것 없지만 레슬링을 열정적으로 사랑하는 충길의 도전을 그린 ‘튼튼이의 모험’이 채널 스크린에서 아침 7시에 방영된다. 
지난 17일부터 18일까지 이틀간 신성대학교 태촌아카데미홀에서 충남체육회가 주최하고 당진시유도회와 충남유도회가 주관한 2018 충남 생활체육 유도대회가 개최되었으며 유치부부터 초·중·고·대학부, 일반부 및 동호인부로 나누어 진행되었다.	지난 17일부터 18일까지 유도동호인의 활동을 활성화하고자 마련된 2018 충남 생활체육 유도대회에서 당진해나루유도관,청룡유도관이 순위를 기록했다. 
광양시는 지난 8일 시청 상황실에서 신규직원의 신속한 조직 적응과 건전한 공직관 형성을 돕기 위한 '2018년도 신규직원 멘토링 결연식'을 개최했다.	지난 8일 광양시는 신규직원의 신속한 조직 적응과 건전한 공직관 형성을 돕기 위한 ‘2018년도 신규직원 멘토링 결연식’을 개최했으며 결연식에는 총 100명의 공무원이 참석해 조직적응과 자기개발 노력을 기울일 것을 다짐했다.
우체방우정청은 경기ㆍ인천지역의 우체국에서 배송되는 설 택배물량이 일 평균 45만 개에 달할 것으로 예상하여 집배 인력을 5천200여 명 확충하였다.	기해년 설날을 일주일가량 앞두고 전국에서 몰린 선물 택배로 바쁜 택배업체들이 미리 집배 인력을 충원하는 등 정시 배달에 총력을 다하고 있다.
부산해경은 지난 15일 밤 9시20분 영도구 청학부두 인근 해상에서 예인선 A(24t) 호가 침몰했다고 밝혔다.	부산해경은 지난 15일 밤 9시20분 영도구 청학부두 인근 해상에서 배의 출·입항을 돕는 예인선 A 호가 부산 영도 앞바다에 가라앉는 사고가 발생했다고 17일 밝혔다.
이철우 경북도지사는 지난 5일부터 7일까지 경북도 해외자문위원회 회장단 회의 참석 및 다국적 기업과의 네트워크 강화를 통한 지역 중소기업 현지 진출을 위해 필리핀에 머물고 있는 김관용 전 지사와의 만남을 요청하였고 김 지사가 흔쾌히 수락했다는 후문이다.	이철우 현 경북도지사가 지난 5일부터 7일까지 경북도 해외자문위원회 회장단 회의 참석 및 다국적 기업과의 네트워크 강화 등을 이유로 필리핀을 방문했으며, 현지에서 김관용 전 경북도지사를 만나 경북도의 발전 방향과 경북이 다시 대한민국의 중심으로 거듭날 수 있도록 노력하자는데 의견을 모았다.
안양시는 현 시금고 은행인 NH농협은행과의 약정기간이 오는 12월 31일로 만료됨에 따라 경쟁 방법으로 차기 시금고를 지정할 계획이라고 4일 밝혔다.	"4일 안양시는 2020년부터 4년간 안양시 자금을 관리할 시금고를 지정할 계획이고, 이를 위해 19일부터 3일간 제안신청서를 받은 후 금고지정심의위원회에서 평가하게 될 예정이라고 밝혔다.
"
평택시는 관내 유치원, 초·중·고·특수학교 등 156개 학교를 대상으로 평택교육지원청을 통해 97건(383억4천300만 원)의 사업을 신청받았으며, 2020년도에는 2016년 대비 58.2% 증가한 356억 원을 편성할 예정이다.	평택시는 '2020년 교육경비 지원사업'에 356억 원을 편성하여 적극 추진하며, 지원대상은 사업의 적정성 등 여러방면을 고려하여 결정한다고 전했다.
15년 간 표류하던 김포 감정4지구 도시개발사업 출자동의안이 시의회 문턱을 넘지 못하고 결국 또 보류됐다.	"김포 감정4지구 도시개발사업 출자동의안이 민간사업자에 대한 특혜의혹 등을 이유로 시의회 문턱을 넘지 못하고 또 보류됐다. 
"
대구시와 경북도는 지난 10일 대경혁신인재양성 프로젝트(HuStar) 혁신아카데미 사업단 신청 접수를 마감한 결과, ICT 분야 외 3개 분야에 대해 대구는 4개 사업단이, 경북은 8개 사업단이 사업계획서를 신청했다고 13일 밝혔다.	대구·경북 12개 사업단이 신청한 HuStar 혁신아카데미는 바이오, ICT 등 6개 분야 9개 선정평가위원회를 구성한 다음, 사업 계획서 검토 및 발표평가, 혁신인재 양성 운영위의 심의를 거쳐 7월 초 분야별 사업단을 최종 확정한다.
한국자산관리공사(캠코)가 부산지역 일자리 창출 활성화 및 사회공헌 사업 추진, 가계·기업 취약부문 경제적 재기 지원 등 사회적 가치 실현을 위해 다양한 사회공헌 사업을 펼칠 예정이다.	한국자산관리공사(캠코)는 부산으로 옮긴 지 5년을 맞이하여 미혼모·다문화가정 경제적 독립과 일자리 창출을 위한 다양한 사업을 진행하고 자영업자들이 다시 일어설 수 있도록 하는 지원을 해준다. 
경남 김해 중소 제조업체들이 올 상반기 경제 여건을 '흐림'으로 분류해 정부 시행 중인 최저임금 등 고용 노동환경 변화(31.9%), 내수 침체 장기화(24.1%), 관련 규제법안(21.5%) 순으로 꼽고 있어 대책 마련이 시급하다는 지적이 나오고 있다.	14일 김해상공회의소에 따르면 김해 중소 제조업체들의 기업 경기전망지수(BSI)가 최저임금 등 고용 노동환경 변화, 내수 침체 장기화, 관련 규제법안 등의 이유로 58.6에 그쳤다.
화성시는 생활SOC복합화 사업에 선정되어 각종 편의시설을 한 공간에 모으는 사업인 '봉담주차문화복합센터'와 '향남문화복합센터, 가족통합센터' 등 총 6곳이 선정돼 국비 230억 원을 확보했다.	"화성시는 정부에서 주관하는 일상생활의 필수 인프라를 구축하여 부지문제 해결 및 시설 이용의 시너지 효과를 위한 ‘생활SOC 복합화 사업’에 선정되어 국비 230억 원을 확보하였다.
"
한국전력구단의 광주 연고지 이전을 촉구하는 지역사회의 목소리가 점점 커지고 있는 가운데 이용섭 시장은 지난 1월 언론사 간담회에서 “한전이 혁신도시에 둥지를 틀었지만 지역민들 사이에서는 ‘우리 한전’이란 말이 나오지 않고 있다”고 밝혀, 한전 배구단의 광주 연고지 이전을 촉구하는 지역사회의 목소리가 커지고 있다.	한국전력 빅스톰 프로배구단의 광주 연고지 이전을 위하여 광주시와 지역 정치권이 나서 본격적인 유치활동을 벌이고 있다.
대구시가 한국가스공사 수소콤플렉스 구축사업의 지역 유치를 중앙정부에 건의하는 등 수소산업 선도도시 도약을 본격화하고 있다.	대구시가 한국가스공사 수소콤플렉스 구축사업의 지역 유치에 본격화하고 있다고 밝혔고 미래에너지 핵심사업 중 하나로 수소연구센터와 유통센터, 충전소 실증사업센터, 교육홍보관을 한 곳에 건립되면 미래 역점사업이란 점이 특징이다.
문재인 정부의 대표적인 복지정책인 '커뮤니티 케어'는 노인, 장애인 등이 살던 집이나 지역에서 개개인의 욕구에 맞는 서비스를 누리고 지역사회와 함께 어울려 살아가도록 지원하는 지역주도형 사회서비스 정책으로 광주 서구를 비롯한 8곳이 선정되어 약 16억원의 예산을 지원 받을 예정이다.	약 16억 원의 예산을 지원 받아 주거·보건의료·요양·돌봄·독립생활을 통합적으로 지원하는 지역주도형 사회서비스 정책 '커뮤니티 케어' 선도사업 추진 자문위원장에 장현 전 광주복지재단 대표이사가 위촉되었다.
대구 수성구청이 지역 한 건설업체에 대해 과거와 유사한 분양 사안임에도 주택법 위반으로 수사의뢰해 '보복행정'이라는 지적이 일고 있다.	대구 수성구청이 2016년 주택조합과 관련하여 수성구청의 잘못된 유권해석으로 벌금을 선고받았으나 소송을 통해 무죄판결을 받은 한 건설업체를 주택법 위반이라는 명목으로 8일 수사를 의뢰하여 보복행정이라는 논란이 일고 있다. 
한국수산자원관리공단은 ‘2018년 남해 바다숲 사업 생태·자원학적 효과조사 결과 보고회’를 지난 21일 열고 갯녹음이 발생하거나 예방이 필요한 해역에 해중림초를 설치하거나 해조류를 이식해 해양생물이 서식하기 좋은 해조군락을 조성하는 사업에 대해 바다숲 조성 후 어획량이 배로 늘고 어류 출현종도 증가했다는 결과를 발표했다.	"한국수산자원관리공단의 ‘2018년 남해 바다숲 사업 생태·자원학적 효과조사 결과 보고회’에 따르면 남해안에 11개 바다숲을 조성한 후 어류 출현 종수가 1.4배 증가했다는 조사결과가 나왔다.
"
이낙연 국무총리는 16일 청주 오창산단 내 미세먼지 배출저감장치 제조기업 (주)에코프로를 방문해, 미세먼지 추경 현황 청취 및 질의·응답과 시설 참관 순으로 진행됐다. 	이낙연 국무총리가 소규모 사업장의 대기오염 방지시설 지원 사업에 대한 현장 의견을 듣기 위해  청주 오창산단 내 미세먼지 배출저감장치 제조기업 ㈜에코프로를 방문했으며, 정부의 추경사업이 조속히 이행될 수 있도록 노력하겠다고 말했다.
아산소비자소비자연합 아산지부 아산소비자상담센터는 지난 23-25일까지 대형할인매장, SSM슈퍼, 일반슈퍼, 재래시장 등 14곳을 대상으로 설 성수품 가격을 조사하였으며 조사한 결과 평균가격이 싼 품목이 2개 품목, SSM슈퍼 10개 품목, 일반슈퍼 8개 품목, 재래시장이 15개 품목으로 나타났다.	아산지역의 차례상 예상 비용은 재래시장이 16만 5532원으로 대형할인매장보다 4만 3379원 저렴하며 품목별 평균가격도 재래시장이 가장 많은 것으로 알려졌다.
여수광양항만공사는 지난해 여수소재 사포부두의 체선율이 25.35%로 전국평균의 10배를 초과하고 있어 이에 대한 대책마련이 시급하다고 지적했다.	여수 소재 일부 항만에서 선박이 항만의 수용능력 이상으로 초과 입항해 항구 밖에서 12시간 이상 하역작업 순서를 기다리는체선율이 전국평균의 약 10배나 초과하고 있어 대책 마련이 시급하지만 항만공사에서는 어떠한 대책도 내놓지 못하고 있다.
여수시는 시민 권익 보호·구제를 위해 23일부터 '찾아가는 시민옴부즈만'을 운영한다.	여수시는 23일부터 시민 권익 보호, 구제를 위한 '찾아가는 시민 옴부즈만'을 권역별로 2개 면사무소와 7개 동주민센터에서 운영한다.
대전상공회의소가 조사한 기업경기실사지수 100 이상이면 경기가 전분기에 비해 호전될 것으로 예상하는 기업이 더 많다는 뜻이고, 100 미만이면 경기가 전분기에 비해 호전될 것으로 예상하는 기업이 더 많다는 뜻이다.	화장품 및 제약 중심의 수출이 증가하고 미중 무역협상의 진전 기대에 따라 기업들의 현장 체감경기지수인 BSI가 4년여 만에 크게 반등하며 100이상시 경기가 호전될 것이라 예상하는 기업이 많다는 의미를 가진 해당지수가 100을 넘어섰다. 
정읍시는 산업통상자원부와 한국산업단지공단이 추진하는 ‘2019년 산업단지 복합문화센터 건립사업’에 최종 선정되어 국비 28억원, 도비 3억6000만원 등 을 지원받아 문화와 복지, 편의 기능이 접목된 복합문화센터를 건립할 예정이다.	정읍시는 '2019년 산업단지 복합문화센터 건립사업'에 선정되어 북카페, 다목적홀, 체육 및 문화 공간 등을 국비 28억을 들여 건립할 예정이다. 
근로정신대 할머니와 함께하는 시민모임은 대법원의 판결에도 강제노역에 대한 피해보상을 이행하지 않은 미쓰비시중공업에 피해보상을 촉구하기 위한 방문단을 모집하며, 방문단은 26일부터 28일까지 2박 3일 일정으로 미쓰비시중공업 주주총회장을 찾아갈 예정이다.	지난해 11월 미쓰비시 등 전범 기업들의 강제노역에 대한 손해배상에 대한 책임을 지라고 한 대법원의 판결에도 불구하고 이를 이행하지 않은 일본의 미쓰비시중공업에 방문단이 파견돼 한국 법원 결정을 조속히 이행하라고 요청할 계획이다. 
광주시가 '광주천 아리랑 문화물길 조성사업'을 통해 광주천을 인간과 동·식물이 공존하는 생태 친수하천으로 복원하고 인근 관광자원을 연계한 문화·관광 벨트를 만들어 광주의 핫 플레이스로 조성할 계획이다.	광주천을 인간과 동·식물이 공존하는 생태 친수하천으로 복원해 인근 관광자원과 연계한 문화·관광 벨트를 조성하는 ‘광주천 아리랑 문화물길 조성사업’이 본격적으로 추진된다.
24일 씨제스 엔터테인먼트는 박유천의 진술을 믿고 조사 결과를 기다렸지만 이와 같은 결과를 접한 후 더 이상은 박유천과 신뢰관계를 회복할 수 없다고 판단되어 전속 계약 해지를 결정했다고 전했다.	박유천의 마약 검사 결과가 양성 반응으로 나오자 그를 믿고 기다린 씨제스 엔터테인먼트는 그와의 신뢰관계를 회복할 수 없다고 판단해 전속 계약 해지를 결정하며 재발 방지를 약속했다.
전남대 농업빅데이터연구실은 빅데이터를 이용해 양파의 단위면적당 수확량을 예측할 수 있는 모형을 개발해 ‘2019 한국품질경영학회’로부터 우수논문상을 받았다.	전남대 농업빅데이터연구실은 18년 간의 환경과 양파 생산량 빅데이터를 활용해 ‘생육 재배 기간별 환경인자의 주효과와 상호작용을 고려한 양파 단위면적당 수확량 예측 모델’을 개발했으며, ‘2019 한국품질경영학회’의 우수논문상을 수상했다.
광주지역 80여 개 시민사회단체는 12일 민화협을 통해 북측 체육성에 2019광주세계수영선수권대회에 북한 선수단과 응원단, 예술단이 참가해 줄 것을 요청하는 서한문을 전달할 예정이다.	11일 사단법인 광주시남북교류협의회는 광주지역 80여 개 시민사회단체의 의지를 담은 ‘2019광주세계수영선수권대회’에 북한 선수단과 응원단, 예술단의 참가를 요청하는 서한문을 전달한다고 밝힌 가운데 12일 민화협을 통해 북측 체육성으로 발송할 것이라 알렸다.
광주시는 17일 시의회 정례회 본회의에서 시내버스 운영자가 도덕적 해이에 빠지거나 지방자치단체가 관리, 감독을 소홀히 하면 언제든지 혈세가 낭비될 우려를 안고 있는 준공영제에 대해 특정감사 실시 요구를 받아들여 의혹이 해소되도록 적극 협조하겠다고 밝혔다.	17일 시의회 정례회 본회의에서 광주시는 혈세 낭비 등의 의문을 해결하기 위해 시내버스 준공영제에 대한 특정감사 실시 요구를 받아들이기로 했다.
다음 달로 예정된 정부의 ‘2019 한·아세안 특별정상회의’ 개최지역 선정과 관련해 부산상공회의소가 3일 한·아세안 특별정상회의를 부산에서 개최하도록 촉구하는 성명서를 발표했다.	"3일 한·아세안 특별정상회의 개최를 앞두고 서울 인천 등이 3파전 양상을 보이는 가운데, 부산상공회의소는 충분한 인프라와 개최 경험을 가진 부산에 유치도록 촉구하는 성명서를 발표했다.
"
지난달 28일 당진시골프협회 제12·13대 당진시골프협회장 이·취임식에서 신도균 회장이 이임하고, 김상기 회장이 취임하였으며 이날 당진시 이규만 자치행정국장은 김상기 취임회장에게 인준패와 협회기를 수여하였다.	지난달 28일 파인스톤컨트리클럽에서 개최된 제12·13대 당진시골프협회장 이·취임식에서 취임한 김상기 회장은 2년의 임기동안 회장직을 열심히 수행할 것이라고 포부를 밝혔다.
홍하은 한국무역협회는 산업통상자원부와 중소벤처기업부 등 범정부적 차원의 수출활력 제고를 위한 행사가 26일 대구 엑스코에서 열렸다고 밝혔다.	한국무역협회는 26일 범정부적 차원의 수출활력 향상을 위한 '대구 수출활력 촉진단' 행사가 엑스코에서 개최되어 수출기업 간담회 등이 열려 수출기업들의 고충과 지원 요구 등을 상세히 챙겼다고 밝혔다.
박근혜 전 대통령 탄핵 이후 제19대 대통령선거일이 오는 5월 9일로 정해졌지만, 선거법 개정에 대한 시민사회의 목소리는 높아지고 있다.	지난 22일 당진지역 시민사회단체들은 구터미널 로터리에서 투표연령 만 18세 하향 조정 및 연동형 비례대표제, 결선 투표제 등을 주장하는 기자회견을 열었다.
우리나라 중노년 10명 중 6명 이상은 좋은 죽음에 대한 조건으로 스스로 준비하면서 주변에 피해를 주지 않아야 한다는 인식을 가진 것으로 나타났다.	보건사회연구원 분석 결과 우리나라 중노년 10명 중 6명 이상은 ‘좋은 죽음’(웰 다잉)의 조건을, 주변에 피해를 주지 않아야 한다는 인식을 가진 것으로 나타나며 2000년대 초반만 해도 ‘오래 사는 것이 좋은 죽음’이라는 인식이 컸지만, 가치관의 급격한 변화로 우리 사회에서 좋은 죽음에 대한 인식이 바뀌고 있다는 결과가 나왔다. 
포천시는 생활SOC 복합화사업에 ‘포천시 함께 해봄 같이 돌봄 통합센터’가 선정되어 국비 65억6천만 원을 확보했다고 밝혔다.	포천시는 보육, 의료, 교통, 문화 등 일상생활에서 국민의 편익을 증진시키기 위해 다양한 시설을 한 공간에 모으는 사업인 2020년도 생활SOC 복합화사업에 ‘포천시 함께 해봄 같이 돌봄 통합센터’가 선정돼 국비 65억6천만 원을 확보하여 2020년부터 2022년까지 지하1층 지상4층 규모로 건설된다고 밝혔다.
나루문학회가 지난달 5일 고대면에 자리한 최정재시인의마을에서 정기총회를 진행한 가운데 신임회장으로 이종미 회장을 선출하고, 2017년 사업·회계 감사보고와 2018년 사업계획을 발표했다.	나루문학회가 정기총회를 진행한 가운데, 향후 1년간 나루문학회 회장으로 활동하게 될 이종미 회장을 선출했으며 이종미 신임회장은 나루문학회는 작품의 수준을 높이는데 노력할 것이라고 밝혔다.
한국해양구조협회 부산지부는 산하 해양특수구조대를 승격하고 민간해양구조대도 통합할 예정이지만 아직 체계적인 교육 훈련과 장비 사용법 숙달 등의 효과를 노린 해양특수구조대 설치를 독려하고 있다.	기존 수중구조봉사대가 민간해양구조대와 통합된 해양특수구조대가 부산에 처음 선보이지만 이들을 지원할 수 있는 근거인 관련 조례가 미비한 상황이다.
검찰은 지난해 2014년 6월 지방선거 자유한국당 대구시장 후보 경선 때 불법 여론조사를 주도한 혐의로 기소된 이재만 전 자유한국당 최고위원에게 징역 2년 6월을 선고했고, 이 전 최고위원은 항소할 방침이다.	13일 검찰은 지난해 비밀 선거사무소 운영 및 금품 제공 등을 통해 불법 여론조사를 실시한 혐의로 구속기소된 이재만 전 자유한국당 최고위원에게 징역 2년 6월 판결을 내렸다.
KIA는거즈가 7일 광주기아챔피언스필드에서 열린 2019 신한은행 마이카 KBO리그 LG트윈스와의 경기에서 9-10으로 패했다.	KIA는 7일 LG트윈스와의 경기에서 8회 초 LG 정주현에게 역전 적시타를 허용해 9-10으로 패배, 36승 1무 51패를 기록하며 8위로 내려앉았다.
송악읍 고대리 당진항 야적장에 쌓여 있는 1만6900여개의 라돈 매트리스 반출이 장마와 천안지역 주민들의 농성으로 인해 지연되고 있다.	라돈 매트리스를 천안 본사로 이송할 계획이 알려지면서 장마와 천안지역 주민들이 농성에 나서 야적장에 쌓인 1만6900여개의 라돈 매트릭스 반출이 중단된 상태다.
삼육대학교 평생교육원은 국가평생교육진흥원의 '학점은행제 학습과정 평가인정'을 받아 골프 I, 스포츠마사지, 스포츠심리학, 운동생리학, 인체생리학, 체육측정평가, 테니스 I, 트레이닝론 등 8개 과목을 신설하여 운영한다.	삼육대학교 평생교육원이 골프 I, 스포츠마사지, 스포츠심리학, 운동생리학, 인체생화학, 체육측정평가, 테니스 I, 트레이닝론 등 8개 과목의 체육학 과정을 신규 개설해 운영한다
올해 자라섬재즈페스티벌은 세계적 재즈 아티스트뿐 아니라 국내 재즈 씬의 모습을 보여줄 수 있는 다양한 장르와 구성으로 성황리에 마무리되었다.	지난 4일부터 3일간 열린 자라섬재즈페스티벌은 이름에 걸맞는 역대 최고의 프로그램이라는 평가 속에서 성황리에 마무리했으며, 제17회 재즈페스티벌은 1년 후 비슷한 기간인 10월 9일부터 10일까지 진행할 예정이다.
청와대는 20일 5.18 진상규명조사위원회 구성을 위한 특별법이 국회를 통과하고 9월 법 시행에 들어갔지만, 위원회가 출범조차 못하고 있다며 조속히 출범시킬 것을 요구했다.	청와대는 20일 고민정 청와대 대변인의 브리핑을 통해 국회 입법취지에 따라 5·18 진상규명조사위원회를 조속히 출범시킬 것을 촉구했으며, 이를 통해  5·18의 철저한 진상규명과 역사적 진실이 밝혀질 것을 기대한다고 했다. 
8일 방송되는 '궁금한 이야기Y'에서는 시청자들이 가장 궁금해 하는 뉴스속의 화제 및 인물을 카메라에 담아 이면에 숨어있는 이야기들을 전달해주는 프로그램이다.	뉴스 속 화제 및 인물의 숨은 이야기를 전하는 프로그램 '궁금한 이야기Y'는 전남 강진 실종 미제사건과 사건의 유력용의자 나 씨에 대한 의혹을 8일 방송한다. 
SK텔레콤과 연세대학교 의료원과 5G·AI·미디어 등 최신 ICT 기술을 활용한 '5G 디지털혁신병원' 구축 협약을 체결해 국가 산업의 경쟁력을 높이는 계기가 될 것으로 기대한다.	SK텔레콤과 연세대학교 의료원은 주요 관계자들이 참석한 가운데 을지로 SK텔레콤 사옥에서 5G·AI·미디어 등 최신 ICT 기술을 활용한 국내 최초의 ‘5G 디지털혁신병원’ 구축 협약을 체결했다고 28일 밝혔다.
박남춘 인천시장이 수출규제 품목 중 하나인 희소금속에 대한 연구 분석과 수입국 다변화 등을 통해 대응하고 있는 기관과 기업의 의견을 듣고 지원대책을 논의하기 위해 26일 한국희소금속산업기술센터와 (주)한국전자재료 등을 방문했다.	박남춘 인천시장은 26일 한국희소금속산업기술센터와 한국전자재료 등을 방문하여 일본 수출규제 대응 현황을 살피고 기술 개발과 혁신을 위한 노력으로 위기를 기회로 살릴 것을 당부했다. 
국민권익위원회는 오는 20일 고양시청, 21일 김포시청, 22일 인천 미추홀구청에서 '찾아가는 이동신문고'를 운영한다고 밝혔다.	국민권익위원회는 20일부터 3일 동안 고양·김포, 인천 미추홀 주민을 대상으로 다양한 분야의 애로사항을 청취하고 해결해주는 ‘찾아가는 이동신문고’를 운영한다.
옥션은 지난해 스포츠 관련 용품 매출 현황을 분석한 결과 배구공보다 크고 가벼운 공을 사용해 배구 코트나 배드민턴 코트 등에서 경기를 즐길 수 있는 소프트발리볼 관련 품목이 전년 대비 48% 증가했고 테니스는 오히려 20% 판매량이 줄었으며 전통적 스포츠용품은 오히려 감소했다고 13일 밝혔다.	최근 많은 사람들이 연령대나 비용,시간,시설 등에 크게 제약이 없는 스포츠를 선호함에 따라, 축구,배구,탁구 같은 전통 스포츠보다 이들 종목을 결합,변형한 '뉴 스포츠' 관련 용품의 판매량이 늘었다
전남축구협회 U14대표팀은 지난 달 28일 출국해 오는 7일까지 9박10일 동안 미국 로스앤젤레스에서 전지훈련에 돌입했으며, 전남 선수들은 LA갤럭시 유스팀 등과 3차례의 평가전을 치르고 미국 메이저리그 프로축구팀 LA갤럭시의 홈스타디움도 둘러본다.	전남축구협회에 따르면 신정식 회장 등 전남축구협회 U14대표팀이 지난 달 28일 미국 로스앤젤레스(LA)로 출국해 오는 7일까지 9박10일의 일정으로 전지훈련에 돌입했다.
한남대학교 강인호 교수는 백마강 백제역사 너울옛길 관광거점시설 디자인 설명을 위한 지역의견 수렴 공청회를 개최하여 해상왕국 백제의 이미지와 백마강의 강물과 너울을 표현한 1안이 가장 많은 지지를 받은 것으로 발표했다.	지난 16일 여성문화회관에서 열린 지역의견 수렴 공청회에서 백마강 백제역사 너울옛길에 세워질 전망탑 디자인 시안에 대한 설명과 설문 결과를 1안이 가장 큰 지지를 받았다.
GS건설이 '신천센트럴자이'의 정당계약이 27일부터 3일간 진행된다.	 대구에서 주거 선호도가 가장 높은 수성구와 밀접해 있어 수성의 라이프 스타일을 향유할 수 있다는 이점이 있고 평균 33.3대 1, 최고 49.5대 1의 청약 경쟁률을 보인 신천 센트럴 자이의 정당계약이 27일부터 3일간 진행되며 또한 동대구역과 복합 환승센터가 가까이 위치하고 있어서 교통과 문화시설도 잘 갖추어져 있다.
질병관리본부는 인플루엔자(독감) 유행주의보가 발령된 지 3주가 지났음에도 인천지역 내 백신 접종자 수가 15만 명 이상인 것으로 나타나 겨울철 건강관리에 비상이 걸렸다.	인천 지역이 인플루엔자 유행주의보 발령된지 3주가 지났음에도 백신 접종자가 적은 것으로 나타나 질병관리본부에서 노약자 등은 지금이라도 받을 것을 권고하고 있다.
울진군은 지난 11일 울진군청 영상회의실에서 (주)소르젠코리아(대표 유재진), SRG 융합과학연구회(회장 이재균), 재단법인 경북해양바이오산업연구원(원장 김태영)과 함께 엑스포공원 동편 1만3천911m2에 20억원을 투자해 조성하는 바이오돔 스마트팜 조성을 위한 4자간 투자양해각서를 체결했다.	울진 엑스포공원에 열대작물 재배 시설과 체험교육장을 조성하기 위하여 ㈜소르젠코리아는 열대작물 재배 바이오 에어돔을 설치하고 울진군은 기반시설을 설치하기위한 행정적인 지원을 하는 협약을 맺었다. 
대구 달배·월성지역에서는 유일한 중·대형 전용단지로 소문난 ‘월배 삼정그린코아 카운티’가 분양시장에서는 소위 ‘카더라’ 통신이 실수요자들과 지역 내 소모임을 통해 번져나가고 있다.	대구 달서구 월배, 월성지역에서 유일한 중대형 전용단지로 소문이 나 월배 삼정그란코아 카운티가 실수요자들에게 입소문이 빠르게 확산되고 있다. 
공수처는 법안이 통과되고 시행된 후 6개월이 지나면 공수처가 출범할 예정이었으나 4+1 합의안에 따르면 기소심의위원회는 설치하지 않기로 했다. 	대통령과 4촌 이내 친인척, 국회의장 및 국회의원, 대법원장 및 대법관, 헌법재판소장 및 헌법재판관, 국무총리 등 고위 공직자 7천여 명을 수사대상으로 하고 공수처장은 국회 동의 없이 대통령이 임명한다는 내용의  고위공직자범죄수사처설치법안이 연내 통과될 경우 빠르면 내년 7월 경에 출범할 수 있을 것으로 전망된다.
자유한국당 문재인정권의 사법 장악 저지 및 사법부 독립수호 특별위원회는 성명서를 내고 사법부 고위직 인사 업무를 담당하는 법무비서관을 특정 단체(국제인권법연구회) 출신 인사들이 연달아 맡고 있는 것은 전례조차 없는 일이라며 김영식 청와대 법무비서관의 임명 철회를 촉구했다.	자유한국당 문재인정권의 사법 장악 저지 및 사법부 독립수호 특별위원회는 지난 22일 성명서를 통해 문재인 정부가 김영식 청와대 법무비서관을 임명한 것은 국제인권법연구회 출신을 연달아 배치하여 정권의 나팔수 노릇을 하게 하는 행위라며 비판했다.
검찰은 그간 국민의 알 권리를 보호하는 차원에서 유지돼 온 공개소환이 재판과정에서 유·무죄 판단이 나오기 전에 출석하는 피의자를 공개하는 것으로 바뀌었다고 밝혔다.	국회는 공개소환 철폐 후 국민의 알 권리를 보장하기 위한 보완대책과 공수처 관련 여러 우려를 해소할 방안을 사속히 마련해야 한다.
3일 포항시청 대회의실에서 국내외 각 분야의 전문가들을 초빙해 신북방정책과 환동해권 경제협력과 경북도의 발전전략을 주제로 '제7회 환동해 국제심포지엄'을 개최하여 신북방정책과 동북아 경제협력에 대해 발표했다.	경북도와 포항시가 손을 잡고 3일 '제7회 환동해 국제심포지엄'을 개최하여 급격한 국제정세의 변화 속에 경북도가 나아가야 할 방안을 구체적으로 모색하기 위해 각 분야 전문가를 초빙, 신북방정책과 환동해 관련 주제를 논의 했다. 
신복위가 올해 1분기 개인워크아웃과 프리워크아웃을 신청한 수가 3만 건에 달하자, 신복위는 연체 기간이 30일이 넘고 90일 미만인 단기 연체 채무자의 상환 기간을 연장하고 이자율을 낮춰주는 제도인 프리워크아웃을 신청한 수가 3만 건에 달했다고 밝혔다.	서민금융 지원 홍보강화로 신용회복위원회에 개인.프리워크아웃 신청수가 3만 건에 달했고 경기 악화지속과 금융 구제 관련 제도로 영세 자영업자·취약차주를 중심으로  채무 상환능력이 저하되고 있기 때문으로 분석했다.
지난 10일 서해중앙신협 4층에서 당진신평로타리클럽 이정재 회장이 이임하고 이정호 회장이 취임하였으며 이임회장 간 클럽기 인수인계와 뱃지 교환이 이루어졌다. 	당진신평로타리클럽 회장 및 임원 이·취임식이 지난 10일 서해중앙신협 4층에서 개최됐다.
전남 완도군은 지난 26일 지역 여건이 달라 획일적인 행정추진으로는 주민 요구를 다 파악할 수 없어 학부모들의 목소리를 직접 듣고, 자녀 양육에 있어 어려운 점은 해결 방안을 모색하여 더 나은 양육·교육 환경을 조성하고자 초·중·고 학부모 60여 명과 정담회를 가졌다.	완도군은 학부모들의 목소리를 직접 듣고 더 나은 양육·교육 환경을 조성하기 위해 학부모 60여 명과 정담회를 가졌는데, 이날 자리에서는 학교 등·하교 버스 지원책, 종합문화센터 설치 등 다양한 의견이 나왔다.
MBC 주말특별기획 ‘황금정원’ 5-8회에서 은동주(한지혜 분)-차필승(이사랑 역) 남매와 혼비백산한 한지혜-이상우의 스틸이 공개되어 기대감을 높이고 있다.	3일 MBC 주말특별기획 ‘황금정원’ 측은 가출한 강준혁-정서연 남매와 혼비백산한 한지혜-이상우의 모습이 담긴 스틸컷을 공개하면서 이들이 향한 곳이 어디일지 본 방송을 앞두고 궁금증을 더욱 고조시켰다.
익산시의 신청사 건립을 위한 행정절차가 마무리되면서 2020년 착공이 가시화되고 있으며, 시는 공유지 개발을 통한 재원확보에 나서는 새로운 방식을 도입하여 재정 부담을 최소화하는 등 사업추진에 속도를 높일 계획이다.	신청사 건립 기본계획을 수립했던 익산시는 행정절차가 마무리됨에 따라 2020년 착공을 시작으로, 사유지 개발을 통한 재원확보로 재정 부담을 최소화하는 등 사업추진에도 속도를 높일 예정이다.
한국광산업진흥회는 지난 14일 포토닉스 허브(유럽광산업클러스터연합)와 상호협력을 위한 양해각서를 체결하여 헬스케어, 레이져 광학 분야의 교류활성화가 기대되며 한-독 양국 광융합산업 교류활성화를 위한 다양한 프로그램을 도입할 예정이다.	한국광산업진흥회는 5개 유럽 연합 국가의 6개 클러스터를 통합한 기관인 포토닉스 허브와 양해각서를 체결하여 헬스케어, 레이져 광학 분야 교류활성화, 공동 R&D 프로젝트 추진 등을 통해 국내 광융합산업 발전을 도모한다.
14일 유성온천역 인근 버스 정류장에 설치된 휴대폰 충전기가 잦은 고장·분실로 제역할을 못하면서 충전기 없이 거치대만 덩그러니 놓여있는 등 애물단지로 전락했다. 	시민들의 편의를 위해 11개의 버스정류장에 설치한 휴대폰 충전기가 잦은 고장과 분실로 애물단지가 됐으며, 대전시 또한 잦은 고장으로 수리 비용이 비싸 유지, 보수가 쉽지 않다는 주장이다.
수원전통문화관이 그 동안 진행한 전통문화예술 프로그램과 '세시풍속 북새통', '생활이 예술이 되다' 등 교육 프로그램의 발자취를 사진으로 되짚어보고자 수원전통문화관 기획전시실에서 전시회를 개최한다.	수원문화재단이 수원전통문화관의 개관 후의 모습을 담은 사진전인 <사진 속 전통을 담다>를 개최해 그동안 진행한 프로그램을 소개할 예정이다.
경기도는 위례신도시를 관할하는 여러 지방자치단체와 행정안전부, 국토교통부, 국민권익위원회 등 관계 기관이 참여한 가운데 23일 성남아트센터에서 '위례신도시 상생협력 행정협의회' 출범식을 개최했다.	경기도는 23일 성남아트센터에서 위례신도시를 관할하는 여러 지방자치단체의 행정 협력을 위한 기구인 ‘위례신도시 상생협력 행정협의회’ 출범식을 개최했는데 이는 단일 생활권이지만 2개 광역단체와 3개 기초단체에 걸쳐있는 위례신도시의 특성때문에 교통체계, 문화·체육시설 건립 등 행정 협력이 절실한 곳이기 때문이다.
이재명 경기지사는 경기도 곳곳에 지어지는 3기 신도시와 분양가상한제 등 부동산 정책의 한계를 지적하며 부동산 불로소득 문제 해결을 위해 더불어민주당 등 더불어민주당에 재차 촉구했다.	22일 국회에서 진행된 민주당 당대표-시도지사 간담회에서 이재명 경기지사는 분양가상한제의 문제점을 지적하며, 투기 문제를 해결하기 위해 불로소득 환원제도에 관심을 가져달라고 말했다. 
인천시 남동구는 다음 달 15일~16일 남동구청에서 진행되는 ‘2019 남동구 행복나눔 김장한마당’에 참여할 구민들을 선착순으로 모집하며, 참여 구민들은 김치 명인 레시피와 일반 국내산 김치 등 두가지 김치 종류를 선택할 수 있다.	인천시 남동구는 어려운 이웃을 위한 나눔 프로그램과 개인 및 단체의 김장담그기 프로그램으로 구성된 ‘2019 남동구 행복나눔 김장한마당’에 참여할 구민들을 모집하며 다음 달 15일과 16일 남동구청에서 진행되며 프로그램 상세 문의와 사전 신청은 남동구청(☎032-453-2231~2236) 또는 남동구 홈페이지를 통해 이달 10일부터 31일까지 선착순으로 모집한다.
행정안전부 전국 243개 지자체가 참여한 가운데 ‘2019년도 안녕 캠페인 우수사례 경진대회’에서 광주시와 광산구가 지역봉사활동을 중심으로 지역사회 문제를 해결하기 위해 지자체-지역자원봉사센터가 주도적으로 나서 추진하는 지역맞춤형 캠페인으로 우수기관으로 선정되어 특별교부세를 획득했다.	지역사회 문제를 해결하기 위해 실시된 '2019 안녕 캠페인 우수사례 경진대회'에서 광주시의 '안녕학교'와 광산구의 '공동육아방'이 각각 우수상과 최우수상을 수상했다. 
2016년 복막암 진단을 받고 투병 중인 이 기자는 공영방송 정상화 투쟁을 주도했다는 이유로 2012년 3월 해직됐다가 2017년 12월 당시 최승호 신임 MBC 사장이 취임하며 복직됐다.	문재인 대통령이 17일 오전 암 투병 중인 이용아 MBC 기자의 병문안을 한 것에 대해 이 기자가 감사함을 표한 가운데, 그가 앓고 있는 복막암에 대한 관심도 커지고 있다.
광주 남구는 유권자 1천380명 가운데 429명(득표율 31.08%)으로부터 표를 받아 올해 남구청에서 추진한 최고의 정책으로 선정되었으며 방역지도 활용 모기 제로화 구축 사업은 전체 유권자 1천380명 가운데 429명(득표율 31.08%)으로부터 표를 받아 올해 남구청에서 추진한 최고의 정책으로 선정되었다.	방역지도를 활용한 모기 제로화 구축 사업이 광주 남구 최고의 정책으로 선정됐다.
제47회 어버이날 대통령 표창을 수상한 유명숙(56·여·광주 서구)씨는 남편과 함께 지체장애인 재활시설에서 봉사활동을 하며 나눔을 실천해왔다.	"제 47회 어버이날 대통령 표창을 수상한 유명숙(56·여·사진)씨는 생계유지과 가정일을 하는 바쁜 일상에서도 투병 중인 아버지를 지극정성으로 돌보았고 ""마땅히 해야할 일을 한 것인데 이렇게 큰 상을 받게 돼 쑥스럽습니다.”라며 수상 소감을 밝혔다."
의정부예술의전당이 다음 달 9일과 10일 의정부시청 앞 광장에서 펼쳐질 제2회 블랙뮤직페스티벌(BMF)을 앞두고  MFBTY, 힙합레이블 AOMG 대표프로듀서인 GRAY, 개성 강한 힙합레이블 Yng&Rich(슈퍼비·UNEDUCATED KID·트웰브), 폭넓은 인기를 끌고 있는 래퍼 창모, 독보적인 보이스의 래퍼 우원재, 고등래퍼3 우승자 이영지 등 유료 공연 못지않은 라인업을 자랑할만한 출연진들을 공개해 기대감을 높이고 있다.	경기관광유망축제로 선정되었던 의정부시 블랙뮤직페스티벌(BMF)는 다음 달 9일과 10일 의정부시청 앞 광장에서 개최되며 타이거JK·윤미래 등 초대가수의 공연과 푸드트럭·플리마켓 등 다양한 볼거리가 제공될 것으로 기대된다. 
게룡시는 한국국토정보공사와 2019년 지적측량 기준점 일제 조사를 합동으로 실시하여 지적측량기준점의 망실 또는 훼손 유무를 파악해 지적측량 시 기준점이 없어 측량이 지연되는 문제점을 보완하고 동일한 측량성과를 제공해 주민불편을 최소화할 예정이다.	게룡시는 한국국토정보공사와 2019년 지적측량 기준점 일제 조사를 합동 실시키로 하고 지적층량의 기초 기준점 전수조사를 바탕으로 시민의 재산권 보호와 토지경계 분쟁을 사전 방지하고 지적행정 신뢰도를 높일 방침이다.
지난달 29일 안신타워 지하 1층 공간나누기에서 제10회 꼬마장터가 열렸으며 최저가 10원짜리 물품도 등장해 재미를 더했다.	지난달 29일 안신타워 공간나누기에서는 어린이들이 안 쓰는 물건을 사고팔면서 경제관념도 익히고, 자원순환 등을 목적으로 하는 제10회 꼬마장터가 열렸다.
광주·전남 범시도민 지원위원회는 최근 한전공대 법인 설립을 신청한 가운데 정치권 일각에서 제기되고 있는 반대 목소리에 대해 문재인 정부와 지역정치권이 분명한 대응에 나서 속도감 있게 추진해야 한다는 성명서를 발표했다.	한국전력이 최근 교육과학부에 법인설립을 신청한 가운데 광주, 전남 범시도민 지원위원회는 한전공대 설립은 국가와 지역균형 발전을 위해 반드시 추진돼야 한다며 한전공대가 차질 없이 설립되고 개교되도록 그 이행을 정부, 한전, 정치권 등에 촉구했다.
리얼미터가 지난달 26일부터 지난 2일까지 전국 만 19세 이상 남녀 1만7천명을 대상으로 조사한 결과 이용섭 광주시장의 직무수행 지지율이 58.2%로 지난달에 이어 2위를 차지했다.	리얼미터가 지난달 26일부터 지난 2일 까지 조사한 결과 이용섭 광주시장의 직무수행 지지율이 3.4% 상승한 58.2%로 지난달에 이어 2위를 차지했다.
인천시는 공촌수계 수돗물 사고와 관련해 두 차례에 걸쳐 보상피해 접수된 보상신청 4만2천463건 중 감액 보상자 2만2천332건(46억8천200만 원)에 대해 25일 최종 신청 접수를 마감한다.	인천시는 공촌수계 수돗물 사고와 관련해서 보상기준을 마련해 전액 보상자에게 14일 보상금을 지급했고, 감액 보상자에 대해서는 8일부터 25일까지 이의 신청을 받고 있다.
예산교육청이 12일부터 13일까지 양 일간 도고 켄싱턴리조트, 충의사 일대에서 윤봉길청소년단 및 교원동아리 130여명이 참석한 가운데 리더십 캠프를 열어 윤봉길의 삶 속에서 나라 사랑 출가의 길, 거사의 길, 순국의 길을 집중 탐구할 수 있는 모둠활동으로 진행되었다.	예산교육청이 12일, 13일 양 일간 도고 켄싱턴리조트, 충의사일대에서 윤봉길청소년단 및 교원동아리 130여명이 참여한 가운데 윤봉길의 삶 속에서 나라 사랑 출가의 길, 거사의 길 등을 집중 탐구할 수 있는 리더십 캠프를 진행했으며, 이번 캠프에서는 이태복 회장을 초빙해 북콘서트를 개최하고 모둠활동 발표시간 이후 생활 속에서 각자 실천할 수 있는 윤봉길정신을 찾고 구체적인 계획을 세워보기도 했다고 밝혔다.
대구시와 리사이클센터는 대구지역 다문화 가정에 세탁기 500대를 기증하는 기증식을 9일 오후 대구 사회복지공동모금회, 대구건강가정다문화가족지원센터협회와 함께 진행한다.	9일 대구시와 리사이클센터는 다문화가정에 세탁기 500대를 기증하는 기증식을 진행하며, 연예인과 스포츠 스타들의 재능기부도 예정돼 있다.
면천읍성안 그 미술관이 꿈다락토요문화학교 1기를 종강하고, 지난 18일까지 프로그램에 참여한 아이들의 작품을 전시했다.	면천읍성안 그 미술관이 꿈다락토요문화학교 <꿈꾸는 미술관, 우리 동네에서 놀다> 프로그램 1기를 종강하고, 지난 13일부터 18일까지 프로그램에 참여한 초등학교 20명의 학생들의 작품을 전시했다.
대전지법 항소부 재판에서 공무원 신분인 50대 음주운전 피고인에 대해 벌금 1000만 원이 선고됐다는 소식이 전해졌다.	대전지법 항소부 재판에서 음주운전을 한 피고인에게 벌금 1000만 원이 선고돼 사회적 경종을 울리고 있다.
광양시청소년문화센터는 8월 한 달간 청소년 선샤인 버스킹, 봉사동아리 UnI의 나라찬 아이들과 체험을 통한 친밀감 형성, 서로 간의 배려와 존중하는 법을 배워가는 등 지역 청소년의 문화와 놀이 공간 역할을 톡톡히 하고 있다.	광양시청소년문화센터가 버스킹, 달란트 시장 등 지역 청소년의 문화와 놀이 공간 역할을 톡톡히 하고 있다.
김상훈 자유한국당 청문 특위 간사는 29일 공동 보도자료를 통해 정세균 국무총리 후보자를 겨냥한 각종 의혹에 대해 명확한 해명을 해 줄 것을 요구했다. 	29일 김상훈·주호영 의원 등 한국당 청문특위 의원들은 국무총리 후보 지명 직전 억대의 채무를 갚아서 생긴 무상 증여 의혹에 이어, 소득세 탈루 의혹까지 제기된 정세균 후보자에게 인사청문회에서의 원활한 검증을 위해 명확한 해명을 촉구했다.
3.1운동과 임시정부 수립 100주년을 맞은 올해 진보와 보수진영 간 역사전쟁이 재연될 가능성이 커지고 있는 가운데, 더불어민주당은 4월 11일을 임시공휴일로 지정할 것을 추진한다.	"더불어민주당과 청와대는 임시정부 수립 100주년인 오는 4월 11일을 임시공휴일로 지정하는 방안을 추진하고 있으나 1948년 8월 15일 정부 수립에 더 큰 의미를 부여하는 보수진영의 거센 반발이 예상되어 진보와 보수진영 간 ‘역사전쟁’이 재연될 가능성이 커지고 있다.
"
광주광역시는 인권친화적 문화 확산과 인권의식 향상을 위해 15일 인권헌장 중심의 일상생활에 나타난 인권침해와 차별사례 돌아보기, 차별없이 함께 살아가는 공동체 모습 등을 주제로 '제7회 인권작품 공모전'을 개최한다고 밝혔다.	광주광역시가 인권친화적 문화 확산과 인권의식 향상을 위해 9월16일까지 '제 7회 인권작품 공모전'을 진행하며, 인권지향성, 창의성, 인권교육및 홍보 활용 가능성 등을 기준으로 심사한 수상작은 세계인권도시포럼, 세계인권선언 71주년 기념주간에 전시하는 등 인권감수성 함양을 위한 교육·홍보 자료로 활용할 예정이다.
2019학년도 대학입시에서 대전 지역은 일반고를 중심으로 서울대 합격생이 지난해 대비 크게 증가한 것으로 나타났으며, 이는 일반고 교육력이 크게 향상된 것으로 볼 수 있다.	17일 지역 교육계에 따르면 2019학년도 대학입시에서 대전 지역 서울대 합격생은 180명으로 지난해보다 33명 증가했으며 이중 27명은 일반고 학생으로 일반고의 서울대 합격생 배출이 지난해 대비 크게 증가한 것으로 나타났다.
올해 아파트 분양시장은 재개발 아파트를 중심으로 진행되었으나 내년 1월은 사실상 분양시장이 개점휴업하고 2월 포스코건설을 시작으로 분양시장이 본격화될 예정이다.	광주는 주택청약업무가 금융결제원에서 한국감정원으로 변경됨에 따라 1월은 주택청약 업무를 할 수 없게 되어 분양시장이 개점휴업하게 되었다.
전라도 땅을 상징하는 ‘황토’를 그룹 이름으로 정한 황토회 회원들은 매회 전시회를 통해 미술 애호가들을 만났으며 올해 50주년을 맞은 대구 지역의 대표적 구상 미술 그룹 ‘이상회’(회장 최경수)가 함께 전시를 꾸민다.	대구의 이상회가 함께 참여하는 그룹전 '황토회 50주년 기념전'이 10월 6일까지 광주 양림미술관에서 열리며, 내년에는 황토회가 대구 전시에 참여한다.
의정부시는 의정부교육지원청을 비롯한 19개 학교와 학교시설개방 활성화를 위한 업무협약을 체결해 학교시설 개방을 위한 행정·재정적 지원을 하고, 교육지원청은 학교장의 의견을 수렴해 시설 개방이 원활히 이뤄지도록 지원한다.	학교시설 공유를 통한 지역주민의 생활편의와 복지 향상을 위해 의정부시는 의정부교육지원청를 비롯해 19개 학교와 ‘2019년 학교시설개방 활성화를 위한 업무협약’을 맺었으며, 이에 따라 시는 학교시설 개방을 위한 행정·재정적 지원을 하고, 교육지원청은 학교장 의견을 수렴해 원활한 시설 개방을 돕는다.
신한대학교는 11일 의정부캠퍼스 본관에서 조직에서 발생할 수 있는 부패행위를 사전에 식별하고 예방하기 위해 고안된 반부패경영시스템 ISO 37001을 국제인증을 획득했다.	신한대학교  본관에서 반부패경영시스템 국제표준인'ISO 37001'인증 수여식 및 현판식을 열었고, lSO 37001 는 국제 표준화기구가 제시하는 표준에 따라 조직에서 발생할 수 있는 부정부패 행위를 식별 및 예방하기 위해 만들어진 반부패경영시스템으로 윤리경영 수준을 한층 향상하고자 도입을 결정했다
경기도내 초·중·고를 대상으로 한 설문조사에서 학생들이 교직원에 비해 성희롱, 성폭력을 경험한 비율이 두 배 이상 높지만 적극적인 대처는 이뤄지지 않는 것으로 나타났다.	13일 경기도교육연구원 진숙경 연구위원은 경기도 내 초·중·고 학생과 교직원들을 대상으로 한 설문조사에서 학생들의 성희롱과 성폭력 피해경험은 0.76회로 0.30회인 교직원에 비해 2배 이상 높게 나타났다고 밝히며, 제도적 시스템 구축과 성 인권 감수성을 높이는 계기가 만들어져야 한다는 의견을 냈다. 
부산대학교 창업지원단은 5월부터 9월까지 약 5개월간 창업 아이디어 개발과 비즈니스모델 수립, 최소요건제품 제작을 지원하는 린스타트업 등을 서바이벌 방식으로 운영하며 우수 교육생 30명을 선발해 최대 1천만 원의 시제품 제작을 지원하고, 최우수 교육생에게는 창업진흥원이 주관하는 예비창업패키지지원사업의 서류심사 면제 혜택을 주게 된다.	부산대학교에서 예비창업자 성공창업 지원을 위해 '2019년 실전창업교육' 1기 교육생 150명을 모집하는데 5개월간 서바이벌 방식으로 운영하며 'K-스타트업(www.k-startup.go.kr)'을 통해 5월 7일까지 신청할 수 있다.
올해로 8회째를 맞는 변호사 시험 합격자 통계에 따르면 충남대·충북대 로스쿨이 비(非)수도권 지역거점 8개 국립대 로스쿨 중 이번 변시 합격률에서 1위를 차지했고 충북대 순위는 뒤로 처진 것으로 나타났다.	충청권 법조인 양성의 중심 공급원으로 규정되는 충남대·충북대 로스쿨이 수도권 쏠림 현상에 따른 양극화의 영향을 받고 있지만 지방 거점대 전위로서의 역할을 충실히 해야한다.
인천시는 2019년 역대 최대 규모의 보통교부세를 확보하면서 굴포천 하수 처리시설 용량, 수도권매립지에 대한 폐기물 처리 수요 등 인천시의 건의한 제도개선이 지속적으로 반영되어 민선 7기 현안사업 추진에 더욱 박차를 가할 수 있게 되었다.	인천시가 2019년 역대 최대 수준의 보통교부세를 확보하면서 현안사업 추진에 박차를 가할 수 있게 되었다.
더불어민주당 지도부는 18일 4·3 국회의원 보궐선거 지역인 경남 통영을 찾아 고용위기지역, 산업위기지역 지정을 끝나는데 당정협의를 통해 기간 연장 및 지원 강화 방안을 강구하겠다고 밝혔고, 자유한국당 지도부는 통영 옛 신아SB조선소 부지에서 최고위원회를 열고 통영형일자리특위를 구성하는 등 통영·고성살리기에 매진하겠다고 밝혔다.	" 4.3 국회의원 보궐선거구 경남 통영을 18일 찾은 더불어민주당과 자유한국당 지도부는 통영 시장 등을 찾아 통영 시민들의 민심을 들으며 자당 후보 지원사격에 나섰다.
"
대전시가 고충민원을 적극적으로 처리한 공직자들을 선발해 표창하는 한편, 현장방문과 주민 합동조사로 진입로를 추가 개설하는 대안을 제시하고 주민합의를 이끌어내 진입로 공사가 정상적으로 추진될 수 있도록 해 안전한 도로환경 조성의 기반을 마련했다.	대전시가 고충민원을 적극적으로 처리하거나 대안을 제시해 시민 만족과 편의를 높인 민원해결사로 유도현 건설관리본부 주무관, 장인환 자원순환과 주무관, 황영선 노인복지과 주무관을 선발해 표창했다.
아주대학교 재학생들로 구성된 '아주 히든챔피언 학생발굴단'은 2일 다산관 강당에서 재학생들에게 소개해 주고 싶은 우수 중소·중견기업 44개 사를 발굴한 뒤 선정된 히든챔피언 12개 기업을 발표하는데 활동 경과보고와 격려사, 학생발굴단 발표, 평가위원·기업 관계자 발표 참관 소감, 시상, 간담회 등의 순으로 진행된다.	아주대 히든챔피언 학생발굴단은 우수한 중소,중견기업을 알리고, 다양한 시각을 갖고 취업을 준비할 수 있는 계기를 제공하기 위해 기업 정보를 공유하는 자리를 마련한다.
대구도시철도공사도 미세먼지 관리목표를 전국 최저수준 유지(50μg/m3 이하)로 잡고 대책마련에 나섰다.	대구도시철도공사가 미세먼지 관리목표를 전국 최저수준을 유지하는 것으로 잡고, 미세먼지 주의보 또는 경보가 나면 마포걸레 청소 6회 이상, 진공청소기로 수시로 청소하고 역사내 공기정화식물 1천399본을 비치하고 출입구 집진발판 444개를 설치하는 등 다양한 대책을 마련하고 있다.
더불어민주당 이해찬 대표는 18일 국회에서 열린 의원총회에서 패스트트랙(신속처리안건)으로 지정된 공직선거법 개정안과 관련하여 자유한국당이 단 한 번도 협상에 응한 적이 없다고 밝혔다.	"더불어민주당 이해찬 대표는 18일 국회에서 열린 의원총회에서 패스트트랙(신속처리안건)으로 지정된 공직선거법 개정안과 국민소환제 도입 등 국회 혁신 문제를 거론하며, ""이번 정기국회가 나라의 명운을 좌우한다는 비상한 각오로 임하겠다”라고 말했다.
"
당진시어린이급식관리지원센터가 어린이 개인위생관리와 식중독 예방을 위해 어린이집과 유치원, 지역아동센터 등 170여 곳을 대상으로 2019년 1차 어린이 위생 방문교육에 돌입했는데, 이번 교육은 연령별 맞춤형 교육으로 우리가 일상생활에서 기본적으로 지켜야 할 손 위생에 대해 다룬다.	당진시어린이급식관리지원센터가 어린이 위생관리와 식중독 예방을 위해 어린이 교육기관 170여 곳을 직접 찾아 '365 뽀드득 손 씻기'라는 주제로 다양한 교구를 활용한 손 위생 교육을 진행하였다. 
어버이날인 8일은 서해상에서 남동진하는 고기압의 영향을 받다가 점차 벗어나며 일교차가 10∼20도 정도로 커 건강관리에 유의해야겠고 8일과 9일은 강원영동에 바람이 29~47km/h(8~13m/s)로 강하게 불겠고, 내륙에서도 14~32km/h(4~9m/s)로 약간 강하게 부는 곳이 있겠으니 시설물 관리에 힘써야겠다.	어버이날인 8일은 전국이 맑다가 오후부터 구름이 많을 전망으로 일교차가 매우 커 건강관리에 유의해야 하며, 미세먼지농도는 보통 수준으로 예상된다.
연일 최고치를 경신하고 있는 미세먼지 농도에서 자유한국당 김석기 의원은 많은 전문가들이 ‘과속 탈원전 정책’을 주요 원인으로 지목하고 있지만 이 정부는 모르쇠로 일관하고 있다며 미세먼지 대책으로 월성1호기 재가동을 주장했다.	자유한국당 김석기 의원이 자신의 페이스북에 미세먼지 농도가 연일 최고치를 기록하고 있는 상황에 정부는 미세먼지 오염도를 알려주는 문자발송 뿐이며 미세먼지 대책들도 땜질식 대책에 불과하다고 지적하며 미세먼지 감축을 위해서는 탈석탄으로 원전 비중을 높여야 하므로 월성1호기 재가동을 주장하고 나섰다.
음주단속 기준강화로 술자리 자체를 기피하는 직장인들이 늘면서 광주지역 외식업계는 주류 판매가 크게 줄었다며 울상을 짓고 있다.	제2 윤창호법으로 불리는 개정 도로교통법이 지난달 25일부터 시행된 지 한 달째를 맞아 음주단속 기준강화로 직장인들의 음주 인식도 변하면서 술자리를 기피하는 사람들이 늘고 있으며 이렇듯 술자리 자체를 꺼리는 상황이 계속되자 광주지역 외식업계들은 주류 판매가 많이 감소했다며 울상이다.
‘SBS 스페셜’에서는 2주간 ‘2019 끼니반란’이라는 주제로 방송되었는데 1편 <간헐적 단식 2.0>은 시청률 8.5%로 같은 시간대 1위를 기록했고, 2편 <먹는 단식 - FMD의 비밀> 편은 시청률 8.5%(닐슨 가구기준, 서울수도권)로 같은 시간대 1위를 기록했다.	시청자들에게 간헐적 단식과 FMD에 대해 쉽게 알려주고자 제작된 ‘SBS 스페셜 2019 끼니반란’이 높은 시청률을 기록하는 등 시청자들 사이에서 화제가 되고 있다. 
2012년부터 이후 7년 만에 마이너스성장 우려를 낳고 있는 인천항 컨테이너 물동량이 올해 들어 10월 말까지 지난해 같은 기간보다 0.7% 감소하면서 인천항 컨테이너 물동량은 2012년 이후 7년 만에 마이너스성장 우려를 낳고 있다.	올해 10월 말까지 지난해보다 0.7%(1만8천521TEU) 감소한 255만1천435TEU을 기록하며 7년 만에 마이너스성장 우려를 낳고 있는 인천항의 컨테이너 물동량에 대한 대책으로 IPA는 중국 동남아향 수출용 냉동·냉장(리퍼)화물 처리 화주 대상 인센티브를 마련할 예정이다.
광주광역시 동구가 노후주거지인 학운2구역에 대해 손실보상 절차를 마무리하고 내년 6월 준공을 목표로 도로 3개 노선 등 주거환경 개선사업을 본격 추진한다.	광주광역시 동구는 학운2구역의 노후불량 건축물과 공·폐가 등이 밀집돼 정비를 위한 ‘학운2구역 주거환경개선사업' 손실보상 절차를 마치고 '도시활력증진지역 개발사업’에 공모해 주거환경 개선사업을 본격 추진한다고 전했다.
지난 16일 태연이 인스타그램 스토리를 통해 팬들과 Q&A 시간을 가진 도중에 언급된 '무엇이든 물어보세요'라고 질문에는 팔로워가 질문을 하면 답변을 하고, 그 내용을 공유할 수 있는 기능이 있어 SNS를 통해 우울증에 대한 우려의 시선이 이어지고 있다.	지난 16일 태연이 인스타그램 스토리를 통해 진행한 '무엇이든 물어보세요'에서 한 누리꾼의 '조울증이냐'는 질문에 태연은 우울증으로 고생 중이라 답했다. 
국민권익위원회는 아버지가 6·25전쟁에 의용경찰로 참전했는데도 당시 주민등록상 나이가 11세에 불과하다는 이유로 참전사실을 인정해 주지 않는 것은 억울하다며 A씨 아버지의 실제나이 및 참전사실을 재조사해 재심의 하도록 경찰청에 시정권고했다.	국민권익위원회는 아버지가 6·25전쟁에 의용경찰로 참전했으나 현행 국방부 참전 훈령에 따라 당시 주민등록상 13세가 되지 않아 이를 인정해 주지 않는 것은 억울하다며 민원을 제기했고, 이에 아버지의 실제 나이 및 참전 사실을 재조사해 다시 심의하도록 경찰청에 권고했다.
전라남도가 올해 문화유산 보존 관리와 재난 예방을 위해 지난해보다 194억원이 늘어난 865억원의 사업비를 투입하여 국가지정문화재 보수정비사업에 470억원이 투입되고, 근대역사문화공간 재생 활성화사업도 처음 시작된다.	전라남도가 올해 문화유산 보존 관리와 재난 예방을 위해 작년보다 194억원이 증가한 865억원의 사업비를 투입하기로 한 가운데, 김명원 전남도 관광문화체육국장은 지역 문화유산을 통한 국민의 문화향유 기회 확대와 관광자원으로의 활용을 위해 지역 문화재 원형 보존과 개보수에 최선을 다하겠다고 밝혔다.
읍면동 주민들에게 시정홍보와 각종 소식을 알리는데 역할을 하는 주민게시판이 사실상 방치되고 있어 효율성을 떨어뜨리고 볼썽사나운 게시판이 도시 미관을 해치는 등 부작용만 낳고 있다.	12개의 읍면동 주민들에게 시정홍보 및 각종 뉴스를 알리기 위해 설치된 주민게시판이 제대로 관리가 되고 있지 않아 제기능을 못할 뿐만 아니라 도시 미관을 방해하는 등 부작용을 낳고 있어 철거하는 것이 낫다는 지적이 이어지고 있다.
메르세데스-벤츠는 스위스 제네바에서 다음달 7일부터 17일까지 개최되는 제 89회 제네바 모터쇼에서 혁신적인 디자인과 무공해 주행을 결합한 ‘컨셉트 EQV(Concept EQV)’와 ‘포뮬러 E 쇼카’ 등 총 6종의 월드 프리미어 모델을 선보인다.	메르세데스-벤츠는 제 89회 제네바 모터쇼(Geneva Motor Show)에서 다목적차량(Multi-Purpose Vehicle, MPV)의 미래를 반영한 순수 전기 배터리로 움직이는 ‘컨셉트 EQV’ 등 6종류의 새로운 자동차를 공개했다. 
한국토지주택공사(LH) 경기지역본부는 양주 옥정·회천지구 내 공동주택용지 2필지를 추첨 방식으로 공급한다고 30일 밝혔다.	풍부한 교통호재를 갖춘 양주 옥정, 회천지구 내 공동주택용지 2필지를 추첨 방식으로 일괄 공급한다고 한국토지주택공사(LH) 경기지역본부가 30일에 밝혔다.
인천시교육청은 사립유치원 에듀파인 전면 도입에 따른 현장 혼란을 방지하기 위해 21일부터 29일까지 유치원 228곳을 대상으로 회계연수를 실시한다.	인천시교육청은 내년 3월부터 사립유치원 에듀파인 전면 도입에 따른 현장 혼란을 최소화하기 위해 지역 내 사립유치원 228곳을 대상으로 회계연수를 실시할 것이며 사립유치원이 에듀파인을 적극 사용하고 건전한 회계 운용을 하도록 지속적으로 지원하겠다고 말했다.
불법촬영란물 유통과 웹하드업계의 카르텔이 사회적 문제로 떠오른 가운데 정부가 24일 정부서울청사에서 제66회 국정현안점검조정회의에서 불법촬영물 유통 근절을 위한 '징역형'만으로 처벌하고 범죄수익을 전액 몰수하는 등의 강도 높은 규제안을 내놓았다.	정부의 '불법음란물 유통근절을 위한 웹하드 카르텔 방지대책'에 따르면 불법음란물 생산 및 유통책과 웹하드 카르텔 가담자는 원칙적으로 구속수사하고 불법촬영물에 대한 공공필터링을 도입해 공공기관이 직접 참여하는 방안이 추진된다.
"경기도의회 기획재정위원회 김경호 의원은 28일 보도자료를 통해 ""하천으로의 기능을 상실했거나 생계형 영업, 영업을 하지 않고 거주를 목적으로 한 주택 등에 대해 대책 없는 단속이 이뤄지고 있다""고 지적했다."	경기도의회 기획재정위원회 김경호의원은 이재명 경기지사의 천·계곡 불법 점용행위 단속이 하천으로의 기능을 상실했거나 개인 하천, 영업을 하지 않고 거주를 목적으로 한 주택 등에 대해서도 대책 없이 추진된다며 단속 이전에 하천구역에 대한 대대적 정비를 통해 기준이 우선 마련되어야 한다고 지적했다.
CBS 스포츠가 류현진이 지난 2년간 메이저리그 전체 1위 평균자책점(2.32)을 올리는 등 2년간 로스앤젤레스 다저스에서 21승 8패, 평균자책점 2.21이라는 좋은 성적을 냈다고 평가했고, 류현진의 새 행선지로 다저스, 로스앤젤레스 에인절스, 샌디에이고 파드리스, 샌프란시스코 자이언츠 등 서부지구 4개 구단을 지목했다.	CBS 스포츠는 류현진을 미국프로야구(MLB) 자유계약선수(FA) 랭킹 6위에 올리고 그가 남긴 성적에 비해선 많은 계약금을 받진 못할 것으로 예상하며 서부지구 4개 구단을 다음 행선지로 지목했다.
17일 음성군이 20주년을 맞이하는 음성품바축제의 성공적 개최를 위해  지난 1월 10일부터 1월 31일까지 전 국민을 대상으로 '제20회 음성품바축제 슬로건 공모전'을 실시한 결과, 임대열 씨의 '20살의 품바! 사랑과 나눔 愛 빠지다'로 故 최귀동 할아버지의 인간 사랑과 나눔을 정신문화축제로 승화시킨 음성품바축제의 20주년을 기념해 20살의 품바가 익살스러운 몸짓과 소리를 통해 사랑과 나눔의 열정에 빠졌다는 의미를 한자 사랑애(愛)를 통해 재미있게 함축하고 있으며 최우수작은 박가원(대구 북구) 씨의 '품바! 세상을 그리다! '로 품바의 가락들이 세상의 모든 희로애락을 그리며 인생의 삶을 표현한다는 비유의 의미를 담고 있으며 우수작은 김영환(충북 보은) 씨의 '품바의 흥! 세계를 품다'로 품바축제가 이제는 더 이상 지역의 축제가 아니고 세계인들이 함께 어울리는 세계의 축제로 품바의 흥으로 세계를 담는다는 의미를 담고 있다.	음성군에 따르면 전 국민을 대상으로 실시한 '제20회 음성 품바축제 슬로건 공모전'에서 698점 중 임대열씨의 '20살의 품바'가 최우수상에 선정 되었다고 발표했다.
공주시가 지난 18일부터 20일까지 열린 '2019 겨울공주 군밤축제'에 대해 관람객 수를 집계한 결과, 1일차 8032명, 2일차 2만 2684명(35%), 3일차에는 3만 4760명(53%)이 다녀갔으며 그 외의 체험프로그램은 군밤을 화로에 구워먹는 '군밤그릴체험'이 28.7%로 1위를 차지했다.	"공주시가 지난 18일부터 20일까지 열린 '2019겨울공주 군밤축제' 를 분석한 결과, 첫날 8032명(12.3%)에 이어 둘쨋날 2만 2684명(35%), 셋째날 3만 4760명(53%) 등 3일 간 총 6만 5476명이 방문했으며, 이 기간 밤 판매액은 1억 5800만원(25톤), 밤 가공식품 1억 500만원 등 총 3억 2150만원이 판매된 것으로 집계됐다.
"
전국이통장연합회 당진시지회 2017년도 첫 월례회의에 임종억 씨가 참석하여 인완진 당진1동 통장협의회장과 임종억 석문면 이장협의회장이 출마한 가운데 투표 결과 임종억 협의회장이 신임 지회장으로 최종 선출됐다.	14개 읍.면.동 이통장협의회장이 대표로 참여하고 있는 전국이통장연합회 당진시지회의 신임지회장으로 임종억 씨가 선출되어 17일 당진시청 중회의실에서 열린 당진시지회에 참석해 임기를 마친 회장과 신임 회장들이 서로 인사를 나누는 자리를 가졌다.
정부가 발표한 발표한 예비타당성조사 면제 대상에서 '신분당선 연장, GTX-B 노선' 등은 서울·경기·인천 등 수도권 사업이 제외되고 접경지역 사업만 제외됐다.	지역균형발전을 취지로 진행한 예비타당성 조사 면제 프로젝트에서 신분당선 연장, GTX-B노선 등이 조사 면제 대상으로 선정되어 신속한 사업 추진이 가능해졌다.
아시아나항공이 경영위기 타개를 위해 자산 추가 매각과 함께 수익구조 개편에 착수하면서 비수익 노선 정리, 조직개편 등 3대 중점과제를 추진하겠다고 밝혔다.	아시아나 항공이 회사의 매각 결정과 함께 수익구조 개편에 착수하면서 비수익 국제선 일부를 정리할 예정인 가운데, 러시아 사할린, 하바롭스크를 비롯한 중국, 일본 등의 노선과 지방 공항발 국제선 일부가 폐지 리스트에 오른 것으로 알려졌다.
국토교통부와 한국교통안전공단은 6일 9개 도 단위 지자체 대상 '2018년도 교통약자 이동 편의 실태조사' 결과를 발표하며 우리나라 교통약자 인구는 전체인구의 28.9%인 1천509만 명으로 전년과 비교하면 26만여 명이 증가했다고 밝혔다. 	국토교통부와 한국교통안전공단이 6일 발표한 '2018년도 교통약자 이동편의 실태조사'에 따르면 우리나라 국민의 1/4에 해당하는 '교통약자'들은 여객선과 버스정류장 시설 이용에 가장 큰 불편함을 느끼는 것으로 드러났다. 
청주시의 고용률, 경제활동참가율, 문화기반·체육시설 수 등 각종 행정통계 지표가 전국 주요도시보다 우위에 있는 것으로 나타났다.	4일 청주시에 따르면 2018년 기준 행정통계를 비교 분석한 결과 각종 행정통계 지표가 전국 주요도시보다 우위에 있는 것으로 나타났다.
의정부시가 자원회수시설(소각장) 이전 건립을 추진 중인 가운데 인근 포천시와 양주시가 반대하고 나서고, 의정부시는 유네스코 생물권보전지역으로 등재된 세계문화유산 국립수목원 반경 5km 이내에 소각장 이전 건립을 추진 중이다.	포천시와 양주시는 의정부시가 추진하려고하는 소각장 이전 건립에 강하게 반발하고 있어 의정부시는 지난달 환경부 중앙환경분쟁조정위원회에 분쟁 조정을 신청해 놓은 상황이다.
광명시는 올해 상반기에 1천229명이 지적전산자료 조회 서비스를 신청했으며 이 중 '내 토지 찾기'와 '조상 땅 찾기' 로 나뉜다.	광명시는 17일 올해 상반기에 시민 1천229명이 지적전산자료 조회를 신청하여 '내 토지 찾기'와 '조상 땅 찾기' 서비스를 이용했고, 또한 시민 372명에 1천380필지의 토지소유현황을 알려주었으며, 시는 이 서비스를 이용하기 위해서는 상속인 본인 신분증과 사망사실을 확인할 수 있는 서류를 준비해 시청 토지정보과 공간정보팀으로 방문하면 된다고 전했다.
한국수자력원자력이 세계중요농업유산에 오른 경남 하동군 화개면 정금리와 부춘리 일원을 양수발전소 건립 예비후보지로 올려 주민이 거세게 반발(국제신문 지난 20일 자 8면 보도)하자 하동군은 화개면 정금리와 부춘리 일원을 양수발전소 건립 예비후보지에서 제외하기로 했다고 21일 밝혔다.	한국수자력원자력이 경남 하동군 화개면 일원을 양수발전소 건립 예비후보지로 올렸으나 주민들이 거세게 반발하여 21일 예비후보지에서 제외하기로 하고 22일에 공식 발표한다.
SK텔레콤은 2016년 1월부터 지난해 4월15일까지 자사 소셜 분석 서비스 플랫폼인 스마트 인사이트를 통해 모두 5만7186건의 빅데이터를 분석하여 가장 비중이 높은 선물은 '용돈'이며 다음으로 '책'과 '케이크'가 집계됐다.	" 2016년 1월부터 지난해 4월15일까지의 빅데이터 분석 결과, SK텔레콤은 어버이날 선물로 가장 비중이 높은 것은 용돈이며, 어머니 선물로는 용돈과 화장품이, 아버지 선물로는 건강식품이 각각 1위를 차지했다고 밝혔다.
"
광주·전남은 6일 밤부터 7일 오전까지 태풍의 간접 영향권에 들겠으나 중형 태풍으로 추정되는 제9호 태풍 ‘레끼마’(LEKIMA)가 프란시스코의 뒤를 이어 오는 11일께 우리나라에 영향을 미칠 것으로 보여 5일 개회하는 ‘2019광주세계마스터즈수영선수권대회’ 조직위원회 등이 바짝 긴장하고 있다.	제8호 소형 태풍 프란시스코가 6일 한반도에 상륙할 것으로 보이며 광주와 전남은 6일 밤부터 7일 오전까지 간접 영향권에 들 것으로 예상된다. 
광주FC가 광주월드컵경기장에서 열린 프로축구 광주FC K리그2 우승 시상식에서 1대2로 패하며 아쉬움을 남겼다.	K리그2 조기우승과 K리그1 승격을 확정 지은 광주FC가 광주월드컵경기장에서 마지막 고별전 전남과의 대결에서 1대2로 패하며 진한 아쉬움을 남겼지만, 올 시즌 끈끈한 조직력과 리그 최소실점(26실점)에 빛나는 탄탄한 수비력을 바탕으로 K리그2 최다무패(19경기), 팀 최다승(20승) 등의 기록을 양산하였다.
전국교직원노동조합 대구지부(이하 전교조 대구지부)는 대구교육청의 초등학교 ‘안전도어구축시스템’ 도입이 아동의 안전과 이익을 최우선으로 고려하지 않은 어른들의 행정편의주의의 극치라고 비판했다.	전국교직원노동조합 대구지부는 10일 성명서를 내고 대구교육청이 추진하고 있는 초등학교 ‘안전도어구축시스템’ 구축이 아동의 안전과 이익을 고려하지 않은 행정편의주의이자 예산낭비라며 전면 재검토와 철회를 요구했다.
야권은 20일 부동산 투기 의혹이 제기된 더불어민주당 손혜원 의원의 해명에도 불구하고 의원직 사퇴를 촉구하고 자유한국당은 손 의원의 기자회견이 알맹이가 없는 내용뿐이라며 강하게 비판했다.	20일 부동산 투기 의혹이 제기된 더불어민주당 손혜원 의원의 해명에도 자유한국당이 손 의원의 기자회견에 알맹이가 없다며 의원직 사퇴를 계속 촉구하는 반면, 민주당은 당 지도부가 기자회견에 참석하는 등 손 의원을 지지하는 뜻을 내비쳐 갈등이 계속되고 있다.
담양읍 담주리 일원 구도심을 '문화생태로 새로운 천년을 디자인다'라는 슬로건 아래 창업·주거·문화 등이 복합된 혁신거점공간으로 조성할 계획이다.	담양군이 도시재생 뉴딜사업 일반근린형 공모에 최종 선정되면서 사업비 154억원을 확보하게 됐고, 내년부터 2023년까지 구도심을 혁신거점공간으로 조성할 계획이다. 
충남도는 보령 공군사격장 주변지역의 소음과 진동 등 환경문제를 해결하기 위한 민·관·군 협의체가 구성되었으며, 나소열 문화체육부지사를 민관군 상생협력 협의회 위원장으로 위촉했다.	충남도는 지난 3월 보령 공군사격장 주변지역 민관군이 상생협력하는 협약을 체결한 이후 22일 도청 상황실에서 '민관군 상생협력 협의회 위촉식'을 개최해 앞으로 군 사격장 주변지역에서 상생협력을 위한 총괄기능을 수행하고 지역공동체 발전 계획을 수립하기로 했다.
당진시 보건소는 지난 24일 고대면을 제1호 치매안심마을로 선정해 어르신과 가족들이 일상생활과 사회 활동에 불편 없이 지낼 수 있도록 지역주민들의 인식개선을 통해 치매 친화적인 환경을 조성하는 사업인 '치매안심마을 운영위원회'를 구성해 운영한다고 밝혔다.	지난24일 당진시 고대면이 제1호 치매안심마을로 선정되면서 당진시 보건소는 지역주민들에게 치매인식개선사업을 전개해 치매환자와 가족, 지역주민이 함께 상생할 수 있는 마을을 조성할수 있는 사업을 실시할 계획이다.
예산군이 청사를 내방하는 군민의 건강을 위해  민원대기실을 비롯한 공공건물 245개소에 공기청정기 727대를 보급했다고 밝혔다.	예산군이 미세먼지로 고생하는 군민들을 위해 추가경정예산을 마련하여 공공건물 245개소에 공기청정기 727대를 보급하였다.
과도한 플라스틱 사용으로 해양생물과 환경을 위협하는 신종 해양물질인 플라스틱에 대해 관심을 가지게 되면서, 수원시는 행궁동 일대를 '일회용 플라스틱 줄이기 시범마을'로 지정하여 시범업소 등록을 독려하고 있지만 많은 점주들이 고객들에게 개인용 텀블러나 다회용 컵을 이용하도록 독려하는 등의 시범사업이 제대로 운영되지 않고 있어 소비자의 관심과 행동 촉구를 위해서는 생산·유통·소비자가 할 수 있는 행동 요령을 구체적으로 고민하고 실천할 수 있도록 하는 방안이 요구된다.	수원시가 행궁동 일대를 ‘일회용 플라스틱 줄이기 시범마을’로 지정하고 주변 카페의 시범업소 등록을 독려하고 있지만 현재 참여율이 낮은 상황으로 생산·유통·소비자의 구체적 행동 지침을 고민하고 실천할 수 있도록 하는 방안 마련과 시와 시민의 노력, 동참이 필요하다고 말했다.
포스코가 오는 7월 3일 포항 실내체육관에서 시 승격 70년 기념 감사콘서트 '함께한 행복'를 갖는다.	7월 3일 종합준공일을 기념하고 포스코의 성장과 발전에 아낌없는 성원과 지지를 보내준 포항시민들에게 감사의 뜻을 표하기 위해 포스코가 오는 7월 3일 오후 7시 30분 포항 실내체육관에서 시 승격 70년 기념 감사콘서트 ‘함께한 행복’을 열어 김건모와 김연자 등 국내 최정상급 가수의 공연 등을 선보인다.
포항시와 '포항 11.15촉발지진 범시민대책위원회'는 4월 2일 '포항 지진 특별법 제정 촉구 및 시민화합을 위한 범시민 결의대회'를 북구 중앙상가 일원에서 가진 데 이어, 4월 25일 세종시 소재 산자부 항의 집회를 가지는 등 여야 대치 및 국회 미개원 등으로 지진특별법 제정이 미뤄지면서 포항시민들의 상처가 깊어지고 있다.	여야간 대치와 국회 미개원으로 지진특별법 제정이 미뤄지면서 '포항 11.15촉발지진 범시민대책위원회'는 세종시 산자부와 여의도 국회를 방문해 항의 집회를 열고 포항 지진 특별법 조기제정을 촉구했다.
경기남부경찰청이 서민을 불안·불신·불행하게 만드는 ‘서민 3불(不)’ 사기범죄에 대한 집중 단속에 나선다.	경기남부경찰청은 생활 주변 사기범죄 근절을 위해 피싱사기, 생활사기, 금융사기를 '서민 3불(불안·불신·불행) 사기범죄'로 지정해 오는 11월까지 11개 부서가 참여한 TF를 중심으로 집중 단속과 예방활동에 나선다고 전했다.
칠곡가산초등학교의 텃밭에는 가을 햇살을 받은 땀방울로 키운 고구마를 캐는 어린이들의 얼굴이 영롱하게 빛나고 있으며 아이들의 순수한 마음처럼 고구마도 골골히 쌓이고 있다.	2012년부터 텃밭에 배추와 고구마, 옥수수, 땅콩 등을 학생과 교직원, 학부모가 직접 기르고 운영하는 칠곡가산초등학교 학생들은 땀의 소중함을 깨닫고 잊지 못할 추억을 쌓으며 자연에서 올바른 인성을 배워 가고 있다.
광주 북구가 오는 15-16일까지 전국 여행사 대표, 사진작가, 파워블로거 등 여행업 관계자 40여명을 초청해 남도여행 팸투어를 실시하며 팸투어를 통해 누정문화, 취가정 등 시가문화 관광자원을 널리 홍보하고 북구와 광주·전남 관광자원을 연계한 상품을 개발해 남도관광의 거점 역할을 수행해나갈 계획이다.	광주 북구가 환벽당, 취가정 등 시가문화권에 산재한 누정문화와 생태자원 등을 널리 홍보하고 북구와 광주·전남 관광자원을 연계한 상품을 개발해 남도관광의 거점 역할을 수행하기 위해 여행업 관계자 40여명을 초청해 남도여행 팸투어를 실시한다.
지난 16일 부산지법 형사3부(문춘언 부장판사) 심리로 진행된 곰탕집 성추행 항소심 세 번째 공판에 피고인 측이 사건이 벌어진 곰탕집 CCTV 영상 감정을 의뢰한 영상전문가가 증인으로 출석하여 피해여성을 지나칠 때 걸리는 시간에 대해 증언했다.	곰탕집 성추행' 사건 항소심 3번째 공판에서, 영상 감정을 맡은 영상전문가는 1.333초라는 짧은 시간에 성추행이 일어나기 어렵다고 분석했으나, 검사는 이 내용에 동의하지 않았다.
4차산업 혁명시대에 핵심인 AI와 빅데이터의 혜택을 대기업 경제력 집중을 제한하고, 대·중·소기업 간의 공정한 경쟁을 보장하며, 중소생산자들을 보호함과 동시에 혁신을 촉진하기 위해 24일 국회의원회관 제10간담회실에서 '4차산업혁명 시대의 중소생산자 유통채널 정책제안을 위한 토론회'가 열린다.	대기업의 경제력 집중 제한, 대·중·소기업 간의 공정한 경쟁 보장 등을 위해 마련된 '4차산업혁명 시대의 중소생산자 유통채널 정책제안을 위한 토론회'가 24일 오후 2시 국회의원회관 제10간담회실에서 진행될 예정이며, 토론회에서는 중소생산자들도 AI와 빅데이터를 활용할 수 있도록 하는 방안을 강구할 예정이다. 
광명도시공사는 글로벌 네이처 브랜드 1위 디스커버리 사가 광명동굴 위탁운용사로 참여하겠다는 사업제안을 하고 광명 문화관광복합단지 조성사업과 관련해 지난 9일 디스커버리 본사 관계자 등이 광명동굴을 현장 방문하여 현재 운영 중인 개방구간과 추후 개발이 필요한 미개방 구간을 안내했다고 11일 전했다.	광명도시공사는 광명 문화관광복합단지 조성사업과 관련하여 광명동굴을 자연주의 테마파크 ‘디스커버리 네이처파크’로 조성하기 위한 사업협약을 체결 하였고, 지난 9일에 광명동굴 운영·관리 사업 위탁운용사로 참여를 추진 중인 디스커버리사와 함께 광명동굴에 대한 마스터 컨셉 및 기본계획을 수립하기 위해 현장을 방문했다.
광양신문 올해 첫 사별연수에 지역신문발전위원회 지원을 받아 고한상 사진작가를 초청하여 '취재에 필요한 스마트폰 사진 강좌와 사진 기본 익히기'라는 주제로 3시간 동안 강의와 질문답변의 시간을 가졌다.	지난달 27일 광양신문은 고한상 사진작가를 초청해 '취재에 필요한 스마트폰 사진 강좌와 사진 기본 익히기'라는 주제로 사별연수를 진행했으며, 고한상 작가는 카메라의 종류, 보도사진에 대한 이해와 가치에 대해 강의했다.
20-21일 이틀간 광주여대유니버시아드체육관과 첨단다목적체육관, 광주전자공고 체육관에서 열리는 '제13회 문화체육관광부장관기 전국 생활체육배구대회'에 국내외 동호인클럽과 직장팀 등 82개팀(남자 48·여자 34) 2천여명이 참가하며, 해외에서는 중국 연변조선족자치주 기업가팀이 출전한다.	대한배구협회 주최·대한배구협회 및 광주배구협회 주관의 '제13회 문화체육관광부장관기 전국 생활체육배구대회'가 20-21일 광주에서 개최돼 남녀 각 부 예선 조별 리그 및 결선 토너먼트 방식으로 진행되며, 3천여명이 광주를 찾을 것으로 예상됨에 따라 오는 7월 시작하는 2019광주세계수영선수권대회 분위기 조성에도 크게 이바지할 것으로 보인다.
행정안전부는 국민생활에 필요한 47종의 '나의 생활정보'를 주민센터를 방문한 민원인의 요청에 의해 민원창구를 통해 확인 또는 제공받을 수 있도록 시스템을 개선했다.	2월 1일부터 주민센터의 민원처리운영창구를 통해 여권만료일, 연금, 휴먼계정 등 47가지 생활정보를 실시간으로 확인할 수 있다.
부산에 ‘미세먼지 특별법’에 따른 비상저감조치가 처음으로 시행되어 선박 등에 대한 제재가 없고, 관련 조례와 단속 규정이 없어 '반쪽'에 그칠 전망이다.	부산시는 '미세먼지 특별법'에 따른 비상저감조치가 처음으로 시행되지만 이 같은 조치로 미세먼지 농도를 낮추기에는 한계가 있다는 목소리가 높아, 부산시는 미세먼지 저감조치와 관련한 조례 제정을 구상하고 있다.
바른미래당 이언주 의원이 지난 20일 4·3 보궐선거 지역인 창원 성산 선거를 위해 창원에서 숙식하는 손 대표에 대해 '찌질한 짓'을 한 것에 대해 징계 요구서를 윤리위원회에 제출할 것으로 23일 오후 3시 기자회견을 연다.	최근 당 지도부와 갈등이 생긴 이언주 의원이 23일 오후3시 기자회견을 열어 바른미래당 탈당을 선언할 것으로 보인다.
제네시스는 14일(현지시각), 미국 디트로이트 코보 센터에서 열린 『2019 북미 국제오토쇼(NAIAS)에서  ‘2019 북미 올해의 차(NACTOY, The North American Car and Truck of the Year)’에 최종 선정됐다고 밝혔다.	14일 미국 디트로이트 코보 센터에서 열린 '2019 북미 국제오토쇼'에 '2019 북미 올해의 차' 승용 부문에 오른 3개 모델 중 제네시스 G70이 최종 선정되었고, 특히 G70은 한국차로는 세번째로 북미 올해의 차에 선정됐다. 
2일은은 중국 산둥반도 부근에 위치한 고기압의 영향으로 맑겠으나 2일은 남서쪽에서 다가오는 기압골의 영향을 받아 흐린 가운데 비 소식이 예보돼 있고, 3일 아침 최저기온은 대구·구미·상주 0°C, 안동·영주·영천·칠곡 영하 2°C, 청송·청도 영하 3°C 등 영하 6°C~영상 4°C의 기온 분포가 예상된다.	이번 주말 대구지역은 기온이 낮 최고 15℃ 안팎을 웃돌며 포근하겠으나 국외 미세먼지가 유입되고 국내 생성 미세먼지가 더해져 높은 미세먼지 농도가 예상된다.
어기구 국회의원은 미세먼지가 세계보건기구 권고기준보다 2배 이상 높은 수치인 25μg/m3까지 상승하는 것에 대해 대응계획 수립기간이 과도하게 장기로 규정돼 있거나 기존 계획의 효과성분석규정의 부재, 대기오염도 발표 및 측정결과 전산망 구축을 의무화 하도록 하는 등의 개정안을 지난 24일 대표발의 했다.	어기구 국회의원이 2012년 이후 꾸준히 증가하고 있는 심각한 미세먼지 문제에 효과적으로 대응하기 위해 대기환경보전법 일부개정법률안을 지난 24일 대표발의해 기존 대책의 미비점을 점검하고 개선책을 마련할 수 있도록 했다.
손혜원 의원에 대한 비리 의혹이 자고 나면 새롭게 터져 나오고 있으며 특히 국립박물관과 보훈처에 자신이 관계하고 있는 나전칠기 작품을 구입하도록 압력을 넣은 것과 홍영표 민주당 대표가 초선 의원의 탈당 기자회견에 참석해 홍 대표의 손을 얹으며 다소곳이 서 있은 사실도 이상하게 여겨진다.	손혜원 의원의 국립박물관과 보훈처 비리, '목포 야행' 사업, 부친의 독립유공자 선정과 관련된 의혹들이 끊임없이 제기되면서 국민의 불신이 커지고 있다. 
의왕시가 안양시 소재 마을버스 업체인 A운수로부터 의왕시 고천동까지 노선을 연장해 달라는 요청을 받고 1년이 넘도록 이를 방치해 특혜의혹 논란이 제기되고 있다.	의왕시가 안양시 마을버스업체에 그린벨트인 시유지를 차고지로 무상사용하도록 허가하고 차고지 미확보시 노선연장 취소를 조건을 했지만 1년 넘게 방치한 것으로 드러나 시 관계자는 차고지 사용 금지와 노선도 예전 노선으로 돌리겠다는 입장을 밝혔다.
동광건설(대표이사 황철재)이 대구 수성구 중동 485-1번지 일원에 공급하는 '수성 뷰웰 리버파크'는 대구시를 남북으로 가로지르는 신천변에 위치하며 교통이 편리하고 교육환경도 뛰어나고 쾌적한 주거환경을 누릴 수 있어 에듀맘들에게 인기가 높을 것으로 예상된다.	동광건설(대표이사 황철재)이 오는 11월 중 공개 예정인 대구 수성구 ‘수성 뷰웰 리버파크’는 신천 둔치를 따라 잘 조성된 강변 산책로와 자전거 도로, 다양한 운동시설은 물론, 인근에 앞산공원과 수성못이 위치해 수성구의 대표적 주거단지로 주목받고 있다.
인제대 부산백병원이 병원-창업기업 간 협력 활성화를 목표로 올해 처음 추진된 '2019년 개방형 실험실 구축사업'에 선정되었다.	보건복지부가 창업기업과 병원 간 협력 활성화를 목적으로 실시하는 '2019년 개방형 실험실 구축사업'에 인제대 부산백병원을 선정했으며 올해부터 오는 2021년까지 총 24억 원의 국비를 지원한다.
지난 14일 최진실 씨의 딸 최준희(17) 양이 자신이 과거 학교폭력 가해자였음을 밝히고, 피해자에게 사과하는 영상을 유튜브에 게시하였다.	"故 최진실 씨의 딸 최준희(17) 양이 자신이 과거 페이스북에서 피해자를 친구들과 욕했고, 차마 입에 담지 못할 언행을 한 학교폭력 가해자였음을 밝히고,  지난 14일 유튜브를 통해 피해자에게 사과하기 위한 영상을 게시하였다.

"
5·18기념재단과 광주전남민주언론시민연합 등이 5·18 왜곡 언론·방송 및 유튜브를 모니터링한 결과 2003년부터 올해까지 총 200건의 불법 영상물이 적발됐고, 이 영상물들은 주로 특정 극우·보수채널에서 제작해 업로드한 것으로 드러났다.	5·18기념재단과 광주전남민주언론시민연합 등이 5·18 왜곡 언론·방송 및 유튜브를 모니터링한 결과 광주 5·18민주화운동을 심각하게 왜곡하거나 폄훼하는 영상물이 2003년부터 올해까지 총 200건이 적발되어 5·18 왜곡 영상을 제작하는 이들을 처벌할 수 있는 법안 통과가 절실하다.
